player,total_games,shots_made,total_shots,shooting%,2pt_made,2pt_attempts,2pt%,3pt_made,3pt_attempts,3pt%,FT_made,FT_Attempts,FT%,total_assists,total_blocks,off_rebound,is_clutch,years_played,clutch_years
A.J. Price,16,11,28,39.29,8,18,44.44,3,10,30.0,3,3,100.0,3,2,1,0.0,4,0.0
Aaron Brooks,109,58,174,33.33,41,103,39.81,17,71,23.94,91,111,81.98,12,19,8,0.0,9,1.0
Aaron Gordon,34,13,32,40.62,8,17,47.06,5,15,33.33,16,19,84.21,9,2,10,0.0,4,0.0
Aaron Gray,14,4,6,66.67,4,6,66.67,0,0,0.0,6,11,54.55,2,0,8,0.0,6,0.0
Aaron Harrison,2,0,2,0.0,0,0,0.0,0,2,0.0,2,3,66.67,0,0,0,0.0,1,0.0
Aaron McKie,7,0,3,0.0,0,2,0.0,0,1,0.0,0,0,0.0,0,1,5,0.0,1,0.0
Aaron Williams,1,1,2,50.0,1,2,50.0,0,0,0.0,0,0,0.0,1,1,0,0.0,1,0.0
Abdel Nader,1,1,1,100.0,1,1,100.0,0,0,0.0,0,0,0.0,1,0,0,0.0,1,0.0
Acie Law,3,1,3,33.33,1,3,33.33,0,0,0.0,0,0,0.0,0,2,0,0.0,3,0.0
Adam Morrison,19,8,28,28.57,5,14,35.71,3,14,21.43,2,4,50.0,2,0,1,0.0,2,0.0
Adonal Foyle,21,7,17,41.18,7,17,41.18,0,0,0.0,4,8,50.0,6,1,13,0.0,3,0.0
Adreian Payne,1,0,1,0.0,0,0,0.0,0,1,0.0,0,0,0.0,0,0,0,0.0,1,0.0
Adrian Griffin,15,3,6,50.0,2,5,40.0,1,1,100.0,1,10,10.0,3,0,4,0.0,3,0.0
Al Harrington,143,73,204,35.78,61,134,45.52,12,70,17.14,71,103,68.93,32,11,36,0.0,10,2.0
Al Horford,186,101,195,51.79,93,171,54.39,8,24,33.33,88,123,71.54,81,11,54,1.0,11,6.0
Al Jefferson,202,178,370,48.11,175,361,48.48,3,9,33.33,79,117,67.52,90,22,80,1.0,12,8.0
Al Thornton,45,21,51,41.18,17,43,39.53,4,8,50.0,33,48,68.75,11,8,13,0.0,4,0.0
Al-Farouq Aminu,83,24,64,37.5,14,34,41.18,10,30,33.33,23,34,67.65,19,2,21,0.0,8,1.0
Alan Anderson,37,21,53,39.62,13,30,43.33,8,23,34.78,20,23,86.96,16,4,4,0.0,5,1.0
Alan Henderson,5,0,3,0.0,0,3,0.0,0,0,0.0,0,0,0.0,0,2,4,0.0,2,0.0
Alan Williams,3,1,2,50.0,1,2,50.0,0,0,0.0,1,3,33.33,0,0,4,0.0,1,0.0
Alec Burks,50,29,65,44.62,25,54,46.3,4,11,36.36,33,39,84.62,10,6,8,1.0,7,1.0
Alex Abrines,11,6,12,50.0,0,2,0.0,6,10,60.0,2,3,66.67,6,0,3,0.0,2,0.0
Alex Caruso,1,0,1,0.0,0,1,0.0,0,0,0.0,0,0,0.0,0,1,1,0.0,1,0.0
Alex Len,26,4,9,44.44,4,9,44.44,0,0,0.0,7,9,77.78,2,2,12,0.0,5,0.0
Alex Poythress,1,1,1,100.0,1,1,100.0,0,0,0.0,0,0,0.0,1,0,0,0.0,1,0.0
Alexander Johnson,3,3,4,75.0,3,4,75.0,0,0,0.0,0,0,0.0,2,0,0,0.0,2,0.0
Alexey Shved,21,6,28,21.43,4,15,26.67,2,13,15.38,14,16,87.5,4,2,1,0.0,3,0.0
Alexis Ajinca,10,6,10,60.0,6,8,75.0,0,2,0.0,0,0,0.0,5,1,0,0.0,6,0.0
Allan Houston,3,3,6,50.0,2,4,50.0,1,2,50.0,0,0,0.0,3,0,0,0.0,1,0.0
Allan Ray,4,3,5,60.0,2,3,66.67,1,2,50.0,0,0,0.0,2,1,2,0.0,1,0.0
Allen Crabbe,44,16,43,37.21,5,15,33.33,11,28,39.29,10,12,83.33,12,2,5,0.0,4,1.0
Allen Iverson,135,92,223,41.26,77,173,44.51,15,50,30.0,120,145,82.76,22,11,6,1.0,6,2.0
Alonzo Gee,48,17,39,43.59,14,25,56.0,3,14,21.43,14,19,73.68,12,2,13,0.0,6,1.0
Alonzo Mourning,33,14,26,53.85,14,25,56.0,0,1,0.0,9,22,40.91,12,3,12,0.0,4,0.0
Amar'e Stoudemire,143,109,194,56.19,103,172,59.88,6,22,27.27,96,124,77.42,67,12,52,1.0,10,6.0
Amir Johnson,102,56,96,58.33,54,92,58.7,2,4,50.0,45,67,67.16,29,11,61,1.0,11,3.0
Anderson Varejao,114,47,77,61.04,46,73,63.01,1,4,25.0,52,79,65.82,33,5,38,1.0,11,1.0
Andray Blatche,64,30,69,43.48,29,63,46.03,1,6,16.67,29,42,69.05,14,4,21,1.0,8,1.0
Andre Barrett,3,1,2,50.0,1,2,50.0,0,0,0.0,1,2,50.0,0,0,1,0.0,2,0.0
Andre Brown,2,3,3,100.0,3,3,100.0,0,0,0.0,1,2,50.0,1,0,1,0.0,2,0.0
Andre Drummond,75,40,65,61.54,40,64,62.5,0,1,0.0,27,70,38.57,24,5,48,1.0,6,3.0
Andre Iguodala,286,130,374,34.76,102,244,41.8,28,130,21.54,182,261,69.73,47,15,42,0.0,14,2.0
Andre Ingram,1,1,1,100.0,0,0,0.0,1,1,100.0,0,0,0.0,1,0,0,0.0,1,0.0
Andre Miller,219,108,303,35.64,98,248,39.52,10,55,18.18,199,269,73.98,26,27,36,0.0,12,3.0
Andre Owens,2,1,3,33.33,0,0,0.0,1,3,33.33,0,0,0.0,0,0,0,0.0,1,0.0
Andre Roberson,24,9,13,69.23,8,9,88.89,1,4,25.0,2,6,33.33,7,1,15,0.0,4,0.0
Andrea Bargnani,105,54,167,32.34,35,93,37.63,19,74,25.68,46,52,88.46,41,4,18,0.0,10,2.0
Andrei Kirilenko,102,35,93,37.63,22,50,44.0,13,43,30.23,73,97,75.26,29,2,16,0.0,9,2.0
Andres Nocioni,107,47,123,38.21,31,69,44.93,16,54,29.63,59,80,73.75,34,8,26,0.0,7,2.0
Andrew Bogut,131,57,120,47.5,57,118,48.31,0,2,0.0,37,58,63.79,27,6,53,1.0,12,2.0
Andrew Bynum,47,25,41,60.98,25,40,62.5,0,1,0.0,21,32,65.62,18,4,15,0.0,8,1.0
Andrew Goudelock,1,0,0,0.0,0,0,0.0,0,0,0.0,1,1,100.0,0,0,0,,1,0.0
Andrew Harrison,7,2,11,18.18,0,4,0.0,2,7,28.57,1,2,50.0,2,2,1,0.0,2,0.0
Andrew Nicholson,8,2,7,28.57,2,4,50.0,0,3,0.0,2,2,100.0,1,1,3,0.0,3,0.0
Andrew Wiggins,109,66,168,39.29,59,134,44.03,7,34,20.59,89,125,71.2,28,9,28,0.0,4,3.0
Andris Biedrins,47,19,29,65.52,19,29,65.52,0,0,0.0,5,11,45.45,13,1,23,0.0,7,0.0
Anfernee Hardaway,14,4,11,36.36,3,5,60.0,1,6,16.67,4,6,66.67,3,1,1,0.0,2,0.0
Antawn Jamison,170,96,243,39.51,75,164,45.73,21,79,26.58,80,112,71.43,63,14,53,0.0,10,4.0
Anthony Bennett,1,0,0,0.0,0,0,0.0,0,0,0.0,0,0,0.0,0,0,0,,1,0.0
Anthony Brown,2,0,0,0.0,0,0,0.0,0,0,0.0,0,0,0.0,0,0,1,,2,0.0
Anthony Carter,37,9,29,31.03,7,16,43.75,2,13,15.38,16,24,66.67,3,0,4,0.0,6,0.0
Anthony Davis,132,91,179,50.84,87,159,54.72,4,20,20.0,110,134,82.09,62,7,42,1.0,6,5.0
Anthony Grundy,1,1,2,50.0,1,1,100.0,0,1,0.0,0,0,0.0,1,0,0,0.0,1,0.0
Anthony Johnson,50,18,61,29.51,11,37,29.73,7,24,29.17,20,28,71.43,11,5,4,0.0,6,0.0
Anthony Morrow,91,46,122,37.7,27,52,51.92,19,70,27.14,52,58,89.66,28,6,16,0.0,9,0.0
Anthony Parker,92,42,115,36.52,17,46,36.96,25,69,36.23,28,40,70.0,24,6,13,0.0,6,1.0
Anthony Peeler,5,1,5,20.0,0,1,0.0,1,4,25.0,0,0,0.0,1,0,2,0.0,1,0.0
Anthony Randolph,11,6,13,46.15,6,12,50.0,0,1,0.0,8,8,100.0,4,0,8,0.0,5,0.0
Anthony Roberson,5,2,9,22.22,1,5,20.0,1,4,25.0,0,0,0.0,1,0,0,0.0,2,0.0
Anthony Tolliver,51,18,47,38.3,10,15,66.67,8,32,25.0,15,21,71.43,14,1,9,0.0,10,0.0
Antoine Walker,63,28,98,28.57,16,47,34.04,12,51,23.53,10,19,52.63,15,4,14,0.0,4,0.0
Antoine Wright,34,11,38,28.95,6,17,35.29,5,21,23.81,2,2,100.0,7,1,5,0.0,4,0.0
Antonio Blakeney,2,1,1,100.0,1,1,100.0,0,0,0.0,2,3,66.67,1,0,0,0.0,1,0.0
Antonio Burks,2,1,3,33.33,0,2,0.0,1,1,100.0,0,0,0.0,0,0,0,0.0,1,0.0
Antonio Daniels,57,23,53,43.4,20,42,47.62,3,11,27.27,54,65,83.08,5,5,2,0.0,5,0.0
Antonio Davis,18,10,14,71.43,10,14,71.43,0,0,0.0,6,10,60.0,5,0,9,0.0,2,0.0
Antonio McDyess,75,31,58,53.45,31,56,55.36,0,2,0.0,24,42,57.14,22,4,28,0.0,7,1.0
Archie Goodwin,5,3,5,60.0,1,3,33.33,2,2,100.0,5,5,100.0,1,0,0,0.0,3,0.0
Armon Johnson,2,2,2,100.0,1,1,100.0,1,1,100.0,0,0,0.0,0,0,0,0.0,1,0.0
Aron Baynes,12,2,4,50.0,2,4,50.0,0,0,0.0,4,4,100.0,1,1,2,0.0,3,0.0
Arron Afflalo,149,95,259,36.68,58,139,41.73,37,120,30.83,91,108,84.26,51,19,12,0.0,10,2.0
Austin Croshere,27,10,30,33.33,7,17,41.18,3,13,23.08,18,21,85.71,6,1,8,0.0,4,0.0
Austin Daye,20,11,27,40.74,5,11,45.45,6,16,37.5,3,3,100.0,8,0,7,0.0,5,0.0
Austin Rivers,41,10,38,26.32,3,14,21.43,7,24,29.17,2,8,25.0,7,5,2,0.0,6,0.0
Avery Bradley,102,49,118,41.53,23,53,43.4,26,65,40.0,27,40,67.5,39,8,8,1.0,7,1.0
Bam Adebayo,6,1,1,100.0,1,1,100.0,0,0,0.0,2,3,66.67,1,0,1,0.0,1,0.0
Baron Davis,122,84,228,36.84,54,119,45.38,30,109,27.52,55,78,70.51,15,9,14,0.0,8,3.0
Ben Gordon,193,149,380,39.21,90,220,40.91,59,160,36.88,182,214,85.05,66,20,13,0.0,11,3.0
Ben Handlogten,1,0,0,0.0,0,0,0.0,0,0,0.0,0,0,0.0,0,0,0,,1,0.0
Ben McLemore,34,10,31,32.26,6,14,42.86,4,17,23.53,19,25,76.0,8,0,3,0.0,5,0.0
Ben Simmons,16,5,11,45.45,5,10,50.0,0,1,0.0,13,19,68.42,4,0,2,0.0,1,1.0
Ben Uzoh,3,1,2,50.0,1,2,50.0,0,0,0.0,3,3,100.0,0,0,0,0.0,2,0.0
Ben Wallace,91,28,49,57.14,26,46,56.52,2,3,66.67,26,67,38.81,16,1,56,0.0,8,0.0
Beno Udrih,111,66,152,43.42,53,115,46.09,13,37,35.14,70,89,78.65,28,7,15,1.0,12,2.0
Bernard James,1,0,0,0.0,0,0,0.0,0,0,0.0,0,0,0.0,0,0,0,,1,0.0
Bernard Robinson,15,6,20,30.0,5,15,33.33,1,5,20.0,7,10,70.0,3,4,5,0.0,3,0.0
Billy Thomas,2,0,2,0.0,0,1,0.0,0,1,0.0,0,0,0.0,0,0,0,0.0,1,0.0
Bismack Biyombo,31,6,9,66.67,6,9,66.67,0,0,0.0,11,17,64.71,4,2,12,0.0,7,0.0
Blake Ahearn,2,0,2,0.0,0,1,0.0,0,1,0.0,0,0,0.0,0,0,0,0.0,1,0.0
Blake Griffin,144,87,175,49.71,77,153,50.33,10,22,45.45,61,96,63.54,53,8,42,1.0,8,6.0
Bo Outlaw,3,1,1,100.0,1,1,100.0,0,0,0.0,0,0,0.0,0,0,0,0.0,2,0.0
Bob Sura,15,5,19,26.32,3,14,21.43,2,5,40.0,6,10,60.0,2,1,2,0.0,1,0.0
Boban Marjanovic,5,3,3,100.0,3,3,100.0,0,0,0.0,3,3,100.0,1,0,2,0.0,2,0.0
Bobby Brown,4,0,3,0.0,0,1,0.0,0,2,0.0,3,4,75.0,0,0,0,0.0,2,0.0
Bobby Jackson,45,19,65,29.23,12,28,42.86,7,37,18.92,22,29,75.86,9,3,9,0.0,5,0.0
Bobby Jones,1,1,1,100.0,0,0,0.0,1,1,100.0,0,0,0.0,1,0,0,0.0,1,0.0
Bobby Portis,10,1,6,16.67,0,4,0.0,1,2,50.0,0,0,0.0,1,0,2,0.0,3,0.0
Bobby Simmons,77,45,82,54.88,28,49,57.14,17,33,51.52,44,55,80.0,32,2,12,1.0,5,2.0
Bogdan Bogdanovic,15,7,15,46.67,2,5,40.0,5,10,50.0,12,15,80.0,3,0,0,0.0,1,1.0
Bojan Bogdanovic,52,32,64,50.0,12,15,80.0,20,49,40.82,28,32,87.5,24,1,5,1.0,4,2.0
Boniface N'Dong,1,0,1,0.0,0,0,0.0,0,1,0.0,2,2,100.0,0,0,0,0.0,1,0.0
Bonzi Wells,28,11,30,36.67,8,24,33.33,3,6,50.0,9,17,52.94,8,3,6,0.0,4,0.0
Boris Diaw,148,69,164,42.07,52,106,49.06,17,58,29.31,38,66,57.58,50,11,38,1.0,13,3.0
Bostjan Nachbar,36,12,29,41.38,5,11,45.45,7,18,38.89,12,15,80.0,9,1,4,0.0,4,0.0
Bracey Wright,2,1,4,25.0,1,2,50.0,0,2,0.0,2,2,100.0,1,0,1,0.0,1,0.0
Brad Miller,124,44,139,31.65,38,107,35.51,6,32,18.75,100,126,79.37,36,13,41,0.0,7,1.0
Bradley Beal,136,76,252,30.16,42,129,32.56,34,123,27.64,116,151,76.82,44,22,13,0.0,6,1.0
Brandan Wright,28,10,24,41.67,10,22,45.45,0,2,0.0,1,8,12.5,6,2,9,0.0,7,0.0
Brandon Bass,83,26,72,36.11,26,71,36.62,0,1,0.0,36,45,80.0,15,10,23,0.0,9,0.0
Brandon Ingram,20,8,21,38.1,6,18,33.33,2,3,66.67,13,18,72.22,3,1,4,0.0,2,1.0
Brandon Jennings,145,69,254,27.17,47,141,33.33,22,113,19.47,126,154,81.82,21,12,12,0.0,8,0.0
Brandon Knight,96,67,192,34.9,44,115,38.26,23,77,29.87,53,66,80.3,18,13,12,0.0,6,1.0
Brandon Paul,1,0,1,0.0,0,0,0.0,0,1,0.0,0,0,0.0,0,0,0,0.0,1,0.0
Brandon Roy,107,95,243,39.09,77,181,42.54,18,62,29.03,79,94,84.04,14,12,21,0.0,5,1.0
Brandon Rush,42,12,31,38.71,5,14,35.71,7,17,41.18,4,7,57.14,8,3,4,0.0,8,0.0
Brendan Haywood,58,14,30,46.67,14,30,46.67,0,0,0.0,17,38,44.74,10,1,28,0.0,10,0.0
Brent Barry,23,9,19,47.37,2,3,66.67,7,16,43.75,8,12,66.67,8,0,4,0.0,5,0.0
Brevin Knight,54,32,85,37.65,31,78,39.74,1,7,14.29,50,70,71.43,5,5,2,0.0,5,0.0
Brian Cardinal,20,5,22,22.73,2,8,25.0,3,14,21.43,4,7,57.14,5,0,4,0.0,7,0.0
Brian Cook,26,13,37,35.14,7,19,36.84,6,18,33.33,9,16,56.25,9,2,11,0.0,4,0.0
Brian Grant,4,1,3,33.33,1,3,33.33,0,0,0.0,0,0,0.0,1,0,1,0.0,2,0.0
Brian Roberts,34,24,49,48.98,14,28,50.0,10,21,47.62,19,20,95.0,6,3,2,0.0,5,1.0
Brian Scalabrine,19,4,12,33.33,2,5,40.0,2,7,28.57,4,4,100.0,3,0,4,0.0,6,0.0
Brian Skinner,14,0,5,0.0,0,5,0.0,0,0,0.0,3,4,75.0,0,1,3,0.0,5,0.0
Briante Weber,2,1,2,50.0,1,2,50.0,0,0,0.0,2,2,100.0,0,0,0,0.0,1,0.0
Brook Lopez,140,78,176,44.32,75,164,45.73,3,12,25.0,78,102,76.47,42,15,62,1.0,10,4.0
Bruce Bowen,51,10,35,28.57,6,18,33.33,4,17,23.53,10,20,50.0,7,1,6,0.0,5,0.0
Bryce Cotton,1,0,0,0.0,0,0,0.0,0,0,0.0,1,1,100.0,0,0,1,,1,0.0
Bryce Dejean-Jones,1,0,0,0.0,0,0,0.0,0,0,0.0,2,2,100.0,0,0,0,,1,0.0
Bryn Forbes,2,1,2,50.0,0,0,0.0,1,2,50.0,0,0,0.0,1,0,0,0.0,2,0.0
Bryon Russell,8,3,8,37.5,2,3,66.67,1,5,20.0,2,2,100.0,2,0,3,0.0,1,0.0
Buddy Hield,27,21,37,56.76,9,19,47.37,12,18,66.67,9,10,90.0,14,3,7,0.0,2,1.0
Byron Mullens,23,15,35,42.86,13,23,56.52,2,12,16.67,8,10,80.0,11,1,8,0.0,4,0.0
C.J. Watson,3,0,2,0.0,0,1,0.0,0,1,0.0,7,7,100.0,0,1,0,0.0,1,0.0
C.J. Williams,4,1,1,100.0,0,0,0.0,1,1,100.0,3,4,75.0,0,0,0,0.0,1,0.0
CJ McCollum,82,56,133,42.11,38,88,43.18,18,45,40.0,62,71,87.32,23,8,6,1.0,5,1.0
CJ Miles,113,43,131,32.82,13,43,30.23,30,88,34.09,54,67,80.6,29,6,15,0.0,12,0.0
CJ Watson,63,34,76,44.74,22,48,45.83,12,28,42.86,39,52,75.0,17,6,7,1.0,8,2.0
Calbert Cheaney,6,6,11,54.55,6,10,60.0,0,1,0.0,2,3,66.67,3,0,3,0.0,2,0.0
Caleb Swanigan,1,1,1,100.0,1,1,100.0,0,0,0.0,0,0,0.0,1,0,0,0.0,1,0.0
Calvin Booth,2,1,1,100.0,0,0,0.0,1,1,100.0,0,0,0.0,1,0,0,0.0,1,0.0
Cameron Payne,3,3,8,37.5,2,5,40.0,1,3,33.33,0,0,0.0,1,1,2,0.0,2,0.0
Caris LeVert,23,7,27,25.93,6,15,40.0,1,12,8.33,11,15,73.33,2,4,6,0.0,2,0.0
Carl Landry,71,35,68,51.47,34,65,52.31,1,3,33.33,48,65,73.85,17,12,24,1.0,9,1.0
Carlos Arroyo,35,17,50,34.0,15,37,40.54,2,13,15.38,45,50,90.0,3,4,1,0.0,6,0.0
Carlos Boozer,156,111,202,54.95,111,201,55.22,0,1,0.0,92,123,74.8,71,28,56,1.0,11,7.0
Carlos Delfino,78,28,83,33.73,13,38,34.21,15,45,33.33,18,32,56.25,22,7,10,0.0,8,1.0
Carmelo Anthony,306,240,602,39.87,194,455,42.64,46,147,31.29,298,365,81.64,89,49,67,0.0,14,7.0
Caron Butler,166,99,211,46.92,70,125,56.0,29,86,33.72,115,141,81.56,39,16,44,1.0,11,5.0
Cartier Martin,15,6,12,50.0,2,2,100.0,4,10,40.0,1,2,50.0,5,0,0,0.0,6,0.0
Casey Jacobsen,6,1,3,33.33,0,0,0.0,1,3,33.33,6,8,75.0,1,0,0,0.0,1,0.0
Cedi Osman,3,1,3,33.33,1,1,100.0,0,2,0.0,3,4,75.0,1,0,1,0.0,1,0.0
Cedric Jackson,1,1,1,100.0,0,0,0.0,1,1,100.0,0,0,0.0,0,0,0,0.0,1,0.0
Chandler Parsons,81,41,96,42.71,24,51,47.06,17,45,37.78,19,27,70.37,23,8,13,1.0,6,3.0
Channing Frye,102,48,137,35.04,31,68,45.59,17,69,24.64,46,61,75.41,35,6,18,0.0,11,0.0
Charles Hayes,40,8,23,34.78,8,23,34.78,0,0,0.0,9,18,50.0,5,3,24,0.0,9,0.0
Charles Jenkins,7,1,7,14.29,1,5,20.0,0,2,0.0,3,6,50.0,0,3,1,0.0,2,0.0
Charlie Bell,55,22,58,37.93,16,30,53.33,6,28,21.43,19,31,61.29,11,3,8,0.0,5,1.0
Charlie Villanueva,100,45,129,34.88,33,66,50.0,12,63,19.05,29,39,74.36,31,4,26,0.0,10,1.0
Charlie Ward,3,2,4,50.0,0,1,0.0,2,3,66.67,0,0,0.0,2,0,0,0.0,1,0.0
Chase Budinger,36,17,39,43.59,8,13,61.54,9,26,34.62,10,14,71.43,12,0,6,0.0,6,0.0
Chauncey Billups,171,95,246,38.62,59,129,45.74,36,117,30.77,235,270,87.04,31,13,10,0.0,10,4.0
Cheick Diallo,2,0,1,0.0,0,1,0.0,0,0,0.0,0,0,0.0,0,0,0,0.0,2,0.0
Cheikh Samb,1,0,1,0.0,0,1,0.0,0,0,0.0,0,0,0.0,0,0,0,0.0,1,0.0
Chris Andersen,26,8,14,57.14,8,14,57.14,0,0,0.0,18,31,58.06,6,1,10,0.0,8,0.0
Chris Bosh,235,146,311,46.95,123,252,48.81,23,59,38.98,155,198,78.28,87,20,67,1.0,12,8.0
Chris Copeland,6,4,10,40.0,3,6,50.0,1,4,25.0,0,0,0.0,2,0,1,0.0,2,0.0
Chris Douglas-Roberts,12,6,15,40.0,5,10,50.0,1,5,20.0,0,2,0.0,2,3,2,0.0,3,0.0
Chris Duhon,80,21,76,27.63,13,44,29.55,8,32,25.0,52,66,78.79,9,7,5,0.0,9,0.0
Chris Hunter,2,1,1,100.0,1,1,100.0,0,0,0.0,1,2,50.0,1,0,0,0.0,1,0.0
Chris Johnson,8,3,6,50.0,1,2,50.0,2,4,50.0,0,0,0.0,1,0,3,0.0,3,0.0
Chris Kaman,98,43,91,47.25,43,88,48.86,0,3,0.0,46,60,76.67,31,10,23,1.0,11,2.0
Chris McCullough,1,0,0,0.0,0,0,0.0,0,0,0.0,0,0,0.0,0,0,1,,1,0.0
Chris Mihm,14,2,6,33.33,2,6,33.33,0,0,0.0,1,5,20.0,1,1,5,0.0,3,0.0
Chris Paul,308,203,532,38.16,180,416,43.27,23,116,19.83,375,437,85.81,26,28,21,0.0,13,4.0
Chris Quinn,14,9,22,40.91,3,11,27.27,6,11,54.55,12,13,92.31,3,1,3,0.0,5,0.0
Chris Richard,1,0,0,0.0,0,0,0.0,0,0,0.0,0,0,0.0,0,0,1,,1,0.0
Chris Singleton,11,3,15,20.0,3,13,23.08,0,2,0.0,6,10,60.0,2,0,5,0.0,3,0.0
Chris Webber,75,53,136,38.97,44,114,38.6,9,22,40.91,50,68,73.53,40,0,15,0.0,3,1.0
Chris Wilcox,41,23,44,52.27,23,44,52.27,0,0,0.0,20,28,71.43,11,3,15,0.0,7,0.0
Chris Wright,2,1,1,100.0,1,1,100.0,0,0,0.0,0,1,0.0,1,0,2,0.0,1,0.0
Christian Eyenga,2,1,1,100.0,1,1,100.0,0,0,0.0,0,0,0.0,1,0,1,0.0,1,0.0
Christian Laettner,5,2,4,50.0,2,4,50.0,0,0,0.0,6,8,75.0,1,0,2,0.0,1,0.0
Christian Wood,1,0,1,0.0,0,1,0.0,0,0,0.0,0,0,0.0,0,0,1,0.0,1,0.0
Chucky Atkins,65,42,86,48.84,23,36,63.89,19,50,38.0,56,77,72.73,14,3,2,1.0,6,2.0
Clar. Weatherspoon,2,2,2,100.0,2,2,100.0,0,0,0.0,0,0,0.0,2,0,1,0.0,1,0.0
Cleanthony Early,4,2,5,40.0,1,2,50.0,1,3,33.33,1,2,50.0,1,1,0,0.0,1,0.0
Clifford Robinson,27,10,22,45.45,6,12,50.0,4,10,40.0,8,11,72.73,7,0,10,0.0,3,0.0
Clint Capela,10,5,6,83.33,5,6,83.33,0,0,0.0,1,1,100.0,4,0,2,0.0,3,0.0
Cody Zeller,33,12,20,60.0,12,20,60.0,0,0,0.0,17,27,62.96,5,1,19,0.0,4,0.0
Cole Aldrich,13,8,14,57.14,8,14,57.14,0,0,0.0,1,1,100.0,3,1,9,0.0,5,0.0
Corey Brewer,95,39,108,36.11,29,72,40.28,10,36,27.78,55,77,71.43,23,6,28,0.0,11,1.0
Corey Maggette,120,68,164,41.46,56,128,43.75,12,36,33.33,178,203,87.68,42,16,17,1.0,8,3.0
Corliss Williamson,23,11,31,35.48,11,30,36.67,0,1,0.0,9,11,81.82,8,1,9,0.0,2,0.0
Cory Alexander,1,0,0,0.0,0,0,0.0,0,0,0.0,2,2,100.0,0,0,0,,1,0.0
Cory Joseph,50,17,36,47.22,14,21,66.67,3,15,20.0,29,39,74.36,7,3,6,0.0,7,1.0
Courtney Lee,129,39,119,32.77,25,63,39.68,14,56,25.0,101,117,86.32,22,6,10,0.0,10,1.0
Craig Brackins,1,0,0,0.0,0,0,0.0,0,0,0.0,0,0,0.0,0,0,0,,1,0.0
Craig Smith,24,11,22,50.0,11,20,55.0,0,2,0.0,9,13,69.23,6,2,13,0.0,5,0.0
Cristiano Felicio,3,0,1,0.0,0,1,0.0,0,0,0.0,2,2,100.0,0,0,5,0.0,2,0.0
Cuttino Mobley,75,35,89,39.33,20,52,38.46,15,37,40.54,55,67,82.09,17,8,8,0.0,5,2.0
D'Angelo Russell,28,14,43,32.56,7,16,43.75,7,27,25.93,15,18,83.33,3,3,1,0.0,3,0.0
D.J. Augustin,101,49,127,38.58,21,60,35.0,28,67,41.79,83,94,88.3,22,10,4,0.0,10,1.0
DJ White,7,3,6,50.0,3,6,50.0,0,0,0.0,3,4,75.0,2,0,3,0.0,3,0.0
DaJuan Summers,3,0,1,0.0,0,0,0.0,0,1,0.0,4,6,66.67,0,0,0,0.0,2,0.0
Daequan Cook,45,15,49,30.61,3,11,27.27,12,38,31.58,23,29,79.31,12,2,3,0.0,6,1.0
Dahntay Jones,30,6,23,26.09,6,20,30.0,0,3,0.0,17,25,68.0,2,3,5,0.0,10,0.0
Dale Davis,16,2,5,40.0,2,5,40.0,0,0,0.0,7,12,58.33,1,1,10,0.0,3,0.0
Damian Jones,1,1,1,100.0,1,1,100.0,0,0,0.0,0,0,0.0,1,0,0,0.0,1,0.0
Damian Lillard,172,147,358,41.06,93,197,47.21,54,161,33.54,192,217,88.48,51,21,17,1.0,6,4.0
Damien Wilkins,41,21,42,50.0,12,22,54.55,9,20,45.0,18,23,78.26,12,3,5,0.0,8,0.0
Damion James,3,0,0,0.0,0,0,0.0,0,0,0.0,0,0,0.0,0,0,0,,2,0.0
Damion Lee,3,0,2,0.0,0,2,0.0,0,0,0.0,1,2,50.0,0,1,0,0.0,1,0.0
Damjan Rudez,4,1,3,33.33,0,0,0.0,1,3,33.33,2,2,100.0,1,0,1,0.0,2,0.0
Damon Jones,67,36,85,42.35,9,22,40.91,27,63,42.86,27,39,69.23,28,3,2,1.0,4,2.0
Damon Stoudamire,53,30,73,41.1,17,37,45.95,13,36,36.11,39,44,88.64,10,3,7,1.0,4,0.0
Damone Brown,2,1,2,50.0,0,0,0.0,1,2,50.0,1,2,50.0,0,0,0,0.0,1,0.0
Dan Dickau,30,20,49,40.82,14,29,48.28,6,20,30.0,35,41,85.37,7,3,1,0.0,4,0.0
Dan Gadzuric,14,4,12,33.33,4,12,33.33,0,0,0.0,1,1,100.0,2,1,10,0.0,5,0.0
Daniel Ewing,5,1,3,33.33,1,3,33.33,0,0,0.0,7,9,77.78,0,0,1,0.0,2,0.0
Daniel Gibson,56,31,69,44.93,10,21,47.62,21,48,43.75,28,33,84.85,22,5,5,1.0,7,1.0
Daniel Theis,1,0,0,0.0,0,0,0.0,0,0,0.0,0,2,0.0,0,0,0,,1,0.0
Danilo Gallinari,117,54,155,34.84,29,64,45.31,25,91,27.47,116,135,85.93,33,6,10,0.0,9,0.0
Danny Fortson,4,2,4,50.0,2,4,50.0,0,0,0.0,1,2,50.0,1,0,2,0.0,2,0.0
Danny Granger,158,82,225,36.44,46,122,37.7,36,103,34.95,119,138,86.23,41,17,25,0.0,9,3.0
Danny Green,91,35,107,32.71,13,33,39.39,22,74,29.73,35,43,81.4,28,7,12,0.0,8,1.0
Dante Cunningham,52,18,52,34.62,15,39,38.46,3,13,23.08,9,17,52.94,15,3,16,0.0,8,1.0
Dante Exum,5,0,2,0.0,0,0,0.0,0,2,0.0,0,0,0.0,0,0,3,0.0,2,0.0
Danuel House,1,0,1,0.0,0,1,0.0,0,0,0.0,2,2,100.0,0,0,0,0.0,1,0.0
Dario Saric,36,14,30,46.67,11,17,64.71,3,13,23.08,21,30,70.0,11,3,6,0.0,2,2.0
Darius Miles,17,12,20,60.0,8,14,57.14,4,6,66.67,7,10,70.0,5,0,4,0.0,3,0.0
Darius Miller,17,5,17,29.41,1,2,50.0,4,15,26.67,6,6,100.0,5,0,1,0.0,2,0.0
Darius Morris,2,0,1,0.0,0,1,0.0,0,0,0.0,0,0,0.0,0,1,0,0.0,1,0.0
Darius Songaila,51,30,56,53.57,28,53,52.83,2,3,66.67,32,37,86.49,24,5,19,0.0,6,1.0
Darko Milicic,22,7,18,38.89,7,18,38.89,0,0,0.0,4,9,44.44,4,0,12,0.0,6,0.0
Darnell Jackson,2,0,2,0.0,0,1,0.0,0,1,0.0,2,2,100.0,0,0,1,0.0,2,0.0
Darrell Armstrong,34,8,22,36.36,6,11,54.55,2,11,18.18,28,47,59.57,2,0,2,0.0,4,0.0
Darrell Arthur,39,14,44,31.82,11,32,34.38,3,12,25.0,13,17,76.47,12,2,11,0.0,7,0.0
Darren Collison,149,77,210,36.67,64,154,41.56,13,56,23.21,111,135,82.22,20,17,12,0.0,9,1.0
Darrick Martin,6,1,11,9.09,0,5,0.0,1,6,16.67,0,2,0.0,1,1,0,0.0,3,0.0
Darvin Ham,1,0,0,0.0,0,0,0.0,0,0,0.0,0,0,0.0,0,0,0,,1,0.0
David Andersen,3,1,3,33.33,1,2,50.0,0,1,0.0,0,0,0.0,0,1,2,0.0,2,0.0
David Harrison,8,4,6,66.67,4,6,66.67,0,0,0.0,2,2,100.0,1,0,5,0.0,3,0.0
David Lee,173,84,154,54.55,84,153,54.9,0,1,0.0,53,76,69.74,57,21,77,1.0,11,5.0
David Noel,1,1,1,100.0,0,0,0.0,1,1,100.0,0,0,0.0,1,0,0,0.0,1,0.0
David Nwaba,11,1,1,100.0,1,1,100.0,0,0,0.0,4,9,44.44,0,0,0,0.0,2,0.0
David Wesley,30,16,42,38.1,9,20,45.0,7,22,31.82,28,38,73.68,10,2,3,0.0,3,1.0
David West,243,156,356,43.82,150,325,46.15,6,31,19.35,136,172,79.07,91,23,92,1.0,13,6.0
Davis Bertans,6,2,9,22.22,0,0,0.0,2,9,22.22,1,2,50.0,2,0,0,0.0,2,0.0
Davon Reed,1,0,0,0.0,0,0,0.0,0,0,0.0,0,0,0.0,0,0,0,,1,0.0
De'Aaron Fox,17,10,23,43.48,9,18,50.0,1,5,20.0,5,8,62.5,3,0,1,0.0,1,1.0
DeAndre Jordan,119,43,49,87.76,43,49,87.76,0,0,0.0,39,81,48.15,29,1,53,0.0,10,0.0
DeAndre Liggins,2,1,2,50.0,1,1,100.0,0,1,0.0,0,0,0.0,1,0,0,0.0,2,0.0
DeAndre' Bembry,2,1,1,100.0,1,1,100.0,0,0,0.0,0,0,0.0,1,0,0,0.0,2,0.0
DeJuan Blair,11,1,6,16.67,1,6,16.67,0,0,0.0,3,4,75.0,1,2,6,0.0,5,0.0
DeMar DeRozan,210,139,370,37.57,132,321,41.12,7,49,14.29,233,291,80.07,44,32,29,0.0,8,4.0
DeMarcus Cousins,180,125,324,38.58,107,264,40.53,18,60,30.0,172,238,72.27,65,41,70,0.0,8,4.0
DeMarcus Nelson,2,1,2,50.0,1,2,50.0,0,0,0.0,0,0,0.0,0,1,0,0.0,1,0.0
DeMarre Carroll,68,22,62,35.48,12,33,36.36,10,29,34.48,16,29,55.17,12,4,21,0.0,8,1.0
DeQuan Jones,1,0,1,0.0,0,1,0.0,0,0,0.0,0,0,0.0,0,1,0,0.0,1,0.0
DeSagana Diop,15,4,8,50.0,4,8,50.0,0,0,0.0,4,13,30.77,3,2,8,0.0,5,0.0
DeShawn Stevenson,81,41,98,41.84,26,56,46.43,15,42,35.71,33,53,62.26,23,5,11,1.0,9,3.0
Dejounte Murray,7,5,9,55.56,4,7,57.14,1,2,50.0,2,4,50.0,2,1,2,0.0,2,0.0
Delon Wright,13,5,8,62.5,3,5,60.0,2,3,66.67,3,4,75.0,3,0,3,0.0,2,0.0
Delonte West,87,38,94,40.43,28,50,56.0,10,44,22.73,56,65,86.15,18,7,11,1.0,8,1.0
Dennis Schroder,52,39,75,52.0,33,56,58.93,6,19,31.58,50,61,81.97,9,8,0,1.0,5,2.0
Dennis Smith Jr.,19,14,29,48.28,8,13,61.54,6,16,37.5,12,17,70.59,2,0,1,0.0,1,1.0
Denzel Valentine,17,1,13,7.69,1,6,16.67,0,7,0.0,2,2,100.0,0,0,1,0.0,2,0.0
DerMarr Johnson,14,4,18,22.22,2,5,40.0,2,13,15.38,3,6,50.0,2,1,1,0.0,3,0.0
Derek Anderson,26,7,27,25.93,4,15,26.67,3,12,25.0,18,20,90.0,2,1,1,0.0,4,0.0
Derek Fisher,146,65,193,33.68,36,99,36.36,29,94,30.85,103,133,77.44,39,11,9,0.0,10,1.0
Deron Williams,241,163,412,39.56,115,262,43.89,48,150,32.0,181,222,81.53,50,25,13,0.0,12,7.0
Derrick Brown,5,2,5,40.0,1,2,50.0,1,3,33.33,0,0,0.0,1,0,3,0.0,3,0.0
Derrick Byars,1,0,1,0.0,0,0,0.0,0,1,0.0,0,0,0.0,0,0,2,0.0,1,0.0
Derrick Favors,82,40,78,51.28,39,76,51.32,1,2,50.0,38,59,64.41,28,7,31,1.0,8,1.0
Derrick Rose,157,131,357,36.69,119,309,38.51,12,48,25.0,109,142,76.76,23,42,19,0.0,8,1.0
Derrick Williams,32,18,35,51.43,13,25,52.0,5,10,50.0,14,21,66.67,14,4,11,0.0,6,0.0
Desmond Mason,59,25,66,37.88,25,64,39.06,0,2,0.0,50,66,75.76,10,6,22,0.0,5,0.0
Devean George,29,6,20,30.0,5,9,55.56,1,11,9.09,7,11,63.64,2,0,6,0.0,5,0.0
Devin Booker,50,34,98,34.69,26,62,41.94,8,36,22.22,31,37,83.78,12,11,3,0.0,3,1.0
Devin Brown,55,14,49,28.57,12,32,37.5,2,17,11.76,40,54,74.07,6,8,19,0.0,6,0.0
Devin Ebanks,1,0,1,0.0,0,0,0.0,0,1,0.0,2,2,100.0,0,0,0,0.0,1,0.0
Devin Harris,158,94,215,43.72,76,146,52.05,18,69,26.09,97,131,74.05,28,9,11,1.0,14,4.0
Devyn Marble,1,0,1,0.0,0,1,0.0,0,0,0.0,0,0,0.0,0,1,0,0.0,1,0.0
Dewayne Dedmon,18,5,12,41.67,3,6,50.0,2,6,33.33,7,8,87.5,4,1,6,0.0,4,1.0
Dikembe Mutombo,9,2,5,40.0,2,5,40.0,0,0,0.0,1,4,25.0,0,0,7,0.0,3,0.0
Dillon Brooks,13,4,10,40.0,2,4,50.0,2,6,33.33,5,5,100.0,3,0,1,0.0,1,1.0
Dion Waiters,79,39,133,29.32,28,84,33.33,11,49,22.45,31,42,73.81,6,9,12,0.0,6,0.0
Dionte Christmas,1,0,1,0.0,0,1,0.0,0,0,0.0,0,0,0.0,0,0,0,0.0,1,0.0
Dirk Nowitzki,341,249,607,41.02,198,445,44.49,51,162,31.48,320,362,88.4,126,21,37,1.0,14,8.0
Domantas Sabonis,6,1,2,50.0,1,2,50.0,0,0,0.0,1,2,50.0,0,1,2,0.0,2,0.0
Dominic McGuire,27,5,12,41.67,5,12,41.67,0,0,0.0,4,5,80.0,2,1,11,0.0,5,0.0
Donald Sloan,16,10,22,45.45,7,16,43.75,3,6,50.0,9,14,64.29,4,2,1,0.0,4,0.0
Donatas Motiejunas,12,7,12,58.33,6,10,60.0,1,2,50.0,4,7,57.14,3,0,2,0.0,4,0.0
Donell Taylor,6,0,3,0.0,0,1,0.0,0,2,0.0,3,4,75.0,0,0,1,0.0,2,0.0
Donovan Mitchell,15,7,30,23.33,5,14,35.71,2,16,12.5,11,13,84.62,1,4,1,0.0,1,0.0
Donta Smith,3,1,1,100.0,1,1,100.0,0,0,0.0,0,2,0.0,0,0,0,0.0,2,0.0
Donte Greene,20,6,16,37.5,4,5,80.0,2,11,18.18,5,6,83.33,2,0,3,0.0,4,0.0
Donyell Marshall,54,28,68,41.18,14,21,66.67,14,47,29.79,18,26,69.23,20,2,13,1.0,4,2.0
Dorell Wright,64,26,62,41.94,11,27,40.74,15,35,42.86,15,21,71.43,20,1,15,0.0,10,1.0
Dorian Finney-Smith,5,0,4,0.0,0,2,0.0,0,2,0.0,1,2,50.0,0,1,1,0.0,2,0.0
Doron Lamb,1,1,1,100.0,0,0,0.0,1,1,100.0,0,0,0.0,1,0,0,0.0,1,0.0
Doug Christie,14,2,6,33.33,0,3,0.0,2,3,66.67,14,16,87.5,2,0,0,0.0,1,0.0
Doug McDermott,21,6,18,33.33,3,7,42.86,3,11,27.27,11,11,100.0,6,1,0,0.0,3,0.0
Dragan Bender,5,0,2,0.0,0,0,0.0,0,2,0.0,0,0,0.0,0,0,0,0.0,2,0.0
Draymond Green,70,24,64,37.5,18,41,43.9,6,23,26.09,28,34,82.35,14,9,33,0.0,6,1.0
Drew Gooden,90,38,91,41.76,36,77,46.75,2,14,14.29,54,72,75.0,24,7,36,1.0,10,1.0
Dwayne Jones,1,1,1,100.0,1,1,100.0,0,0,0.0,0,1,0.0,1,0,0,0.0,1,0.0
Dwight Buycks,1,0,3,0.0,0,1,0.0,0,2,0.0,0,0,0.0,0,0,0,0.0,1,0.0
Dwight Howard,251,77,136,56.62,77,134,57.46,0,2,0.0,161,258,62.4,41,13,116,1.0,14,3.0
Dwight Powell,9,2,2,100.0,1,1,100.0,1,1,100.0,3,6,50.0,1,0,2,0.0,3,0.0
Dwyane Wade,301,246,608,40.46,210,464,45.26,36,144,25.0,338,457,73.96,48,23,45,1.0,14,6.0
E'Twaun Moore,59,19,58,32.76,11,33,33.33,8,25,32.0,8,14,57.14,9,3,9,0.0,7,1.0
Earl Barron,6,4,7,57.14,4,7,57.14,0,0,0.0,1,1,100.0,4,0,0,0.0,5,0.0
Earl Boykins,60,32,78,41.03,22,45,48.89,10,33,30.3,40,46,86.96,11,2,5,1.0,7,2.0
Earl Clark,11,3,8,37.5,1,2,50.0,2,6,33.33,1,3,33.33,3,0,2,0.0,2,0.0
Earl Watson,81,28,78,35.9,20,45,44.44,8,33,24.24,22,33,66.67,12,1,12,0.0,9,1.0
Ed Davis,33,11,15,73.33,11,15,73.33,0,0,0.0,5,9,55.56,6,0,17,0.0,8,0.0
Eddie Gill,3,0,1,0.0,0,1,0.0,0,0,0.0,0,0,0.0,0,0,0,0.0,1,0.0
Eddie Griffin,14,7,13,53.85,6,9,66.67,1,4,25.0,9,11,81.82,5,0,9,0.0,2,0.0
Eddie House,49,21,61,34.43,7,19,36.84,14,42,33.33,24,28,85.71,17,0,7,0.0,7,0.0
Eddie Jones,58,29,77,37.66,18,37,48.65,11,40,27.5,28,37,75.68,24,1,7,0.0,4,0.0
Eddy Curry,63,43,75,57.33,42,74,56.76,1,1,100.0,39,58,67.24,30,7,24,1.0,4,2.0
Eduardo Najera,36,14,35,40.0,12,28,42.86,2,7,28.57,7,12,58.33,6,3,21,0.0,8,0.0
Ekpe Udoh,19,6,13,46.15,6,13,46.15,0,0,0.0,8,9,88.89,5,0,5,0.0,4,0.0
Elfrid Payton,62,37,89,41.57,33,73,45.21,4,16,25.0,25,36,69.44,5,12,8,1.0,4,3.0
Elijah Millsap,4,0,3,0.0,0,3,0.0,0,0,0.0,2,2,100.0,0,1,0,0.0,1,0.0
Elliot Williams,2,0,1,0.0,0,0,0.0,0,1,0.0,0,0,0.0,0,0,0,0.0,1,0.0
Elton Brand,137,74,167,44.31,74,167,44.31,0,0,0.0,50,67,74.63,46,4,52,1.0,9,3.0
Emeka Okafor,131,57,110,51.82,57,109,52.29,0,1,0.0,68,120,56.67,33,16,74,1.0,9,3.0
Emmanuel Mudiay,35,15,45,33.33,11,31,35.48,4,14,28.57,36,45,80.0,3,5,2,0.0,3,0.0
Enes Kanter,40,16,35,45.71,16,32,50.0,0,3,0.0,4,4,100.0,7,5,13,0.0,7,0.0
Eric Bledsoe,125,89,194,45.88,71,141,50.35,18,53,33.96,108,132,81.82,17,15,19,1.0,8,3.0
Eric Gordon,126,71,173,41.04,38,92,41.3,33,81,40.74,72,85,84.71,38,13,12,1.0,10,4.0
Eric Maynor,6,4,8,50.0,4,6,66.67,0,2,0.0,6,9,66.67,0,1,1,0.0,3,0.0
Eric Piatkowski,2,0,1,0.0,0,0,0.0,0,1,0.0,2,2,100.0,0,0,0,0.0,2,0.0
Eric Snow,28,5,22,22.73,5,20,25.0,0,2,0.0,9,15,60.0,5,4,6,0.0,3,0.0
Eric Williams,9,3,10,30.0,2,6,33.33,1,4,25.0,8,9,88.89,3,0,5,0.0,2,0.0
Erick Dampier,48,11,21,52.38,11,21,52.38,0,0,0.0,8,18,44.44,4,0,32,0.0,7,0.0
Erick Strickland,2,0,0,0.0,0,0,0.0,0,0,0.0,2,2,100.0,0,0,0,,1,0.0
Ersan Ilyasova,126,56,126,44.44,42,86,48.84,14,40,35.0,71,100,71.0,39,9,52,1.0,10,4.0
Etan Thomas,9,1,5,20.0,1,5,20.0,0,0,0.0,4,8,50.0,1,0,6,0.0,4,0.0
Evan Fournier,79,45,115,39.13,25,53,47.17,20,62,32.26,44,59,74.58,25,15,8,0.0,5,3.0
Evan Turner,103,64,159,40.25,59,136,43.38,5,23,21.74,66,102,64.71,19,21,16,1.0,8,1.0
Fabricio Oberto,11,2,4,50.0,2,4,50.0,0,0,0.0,0,0,0.0,2,0,4,0.0,4,0.0
Festus Ezeli,5,2,4,50.0,2,4,50.0,0,0,0.0,0,0,0.0,2,0,4,0.0,2,0.0
Francisco Elson,13,1,5,20.0,1,5,20.0,0,0,0.0,4,5,80.0,1,1,7,0.0,6,0.0
Francisco Garcia,71,30,84,35.71,13,29,44.83,17,55,30.91,20,24,83.33,24,0,4,0.0,10,1.0
Frank Kaminsky,23,7,25,28.0,3,10,30.0,4,15,26.67,7,8,87.5,7,3,7,0.0,3,0.0
Frank Mason,1,1,1,100.0,1,1,100.0,0,0,0.0,0,0,0.0,0,0,0,0.0,1,0.0
Frank Ntilikina,5,1,4,25.0,0,2,0.0,1,2,50.0,1,2,50.0,1,0,1,0.0,1,0.0
Fred Hoiberg,10,1,2,50.0,0,0,0.0,1,2,50.0,11,14,78.57,1,1,0,0.0,1,0.0
Fred Jones,56,17,51,33.33,11,30,36.67,6,21,28.57,32,43,74.42,7,7,6,0.0,5,0.0
Fred VanVleet,8,4,10,40.0,1,3,33.33,3,7,42.86,3,5,60.0,4,1,1,0.0,2,0.0
Furkan Aldemir,1,0,0,0.0,0,0,0.0,0,0,0.0,0,0,0.0,0,0,1,,1,0.0
Garrett Temple,44,9,33,27.27,4,14,28.57,5,19,26.32,16,26,61.54,6,3,6,0.0,7,0.0
Gary Forbes,6,3,5,60.0,3,4,75.0,0,1,0.0,3,7,42.86,0,0,4,0.0,2,0.0
Gary Harris,37,12,34,35.29,8,11,72.73,4,23,17.39,10,12,83.33,7,0,5,0.0,4,2.0
Gary Neal,52,20,76,26.32,9,33,27.27,11,43,25.58,30,40,75.0,13,1,6,0.0,6,0.0
Gary Payton,46,14,37,37.84,7,21,33.33,7,16,43.75,17,27,62.96,7,5,5,0.0,3,1.0
George Hill,130,63,174,36.21,40,84,47.62,23,90,25.56,107,153,69.93,24,12,16,0.0,10,1.0
George Lynch,4,1,2,50.0,0,1,0.0,1,1,100.0,0,0,0.0,1,0,1,0.0,1,0.0
Georgios Papagiannis,1,0,0,0.0,0,0,0.0,0,0,0.0,0,0,0.0,0,0,1,,1,0.0
Gerald Green,61,26,72,36.11,16,33,48.48,10,39,25.64,28,34,82.35,20,3,5,0.0,10,0.0
Gerald Henderson,99,54,141,38.3,44,111,39.64,10,30,33.33,55,67,82.09,29,11,15,0.0,8,2.0
Gerald Wallace,178,74,194,38.14,60,135,44.44,14,59,23.73,104,153,67.97,38,18,61,0.0,11,2.0
Giannis Antetokounmpo,100,47,109,43.12,45,93,48.39,2,16,12.5,57,84,67.86,11,5,20,1.0,5,3.0
Gilbert Arenas,120,101,246,41.06,74,162,45.68,27,84,32.14,136,170,80.0,31,19,11,1.0,8,3.0
Glen Davis,63,30,70,42.86,28,60,46.67,2,10,20.0,33,45,73.33,23,5,21,1.0,7,1.0
Glen Rice Jr.,1,0,1,0.0,0,0,0.0,0,1,0.0,0,0,0.0,0,0,0,0.0,1,0.0
Glenn Robinson,4,1,2,50.0,1,1,100.0,0,1,0.0,2,4,50.0,1,0,1,0.0,3,0.0
Glenn Robinson III,4,1,3,33.33,1,2,50.0,0,1,0.0,2,4,50.0,1,0,0,0.0,2,0.0
Goran Dragic,147,68,169,40.24,55,125,44.0,13,44,29.55,80,107,74.77,23,8,17,1.0,10,2.0
Gordan Giricek,18,4,18,22.22,4,15,26.67,0,3,0.0,3,4,75.0,3,2,0,0.0,3,0.0
Gordon Hayward,139,77,186,41.4,63,131,48.09,14,55,25.45,134,163,82.21,25,8,20,1.0,7,2.0
Gorgui Dieng,50,24,37,64.86,21,31,67.74,3,6,50.0,17,24,70.83,16,3,22,0.0,5,1.0
Grant Hill,127,67,131,51.15,58,113,51.33,9,18,50.0,63,85,74.12,38,8,27,1.0,9,4.0
Greg Buckner,26,4,14,28.57,3,8,37.5,1,6,16.67,3,4,75.0,3,2,5,0.0,5,0.0
Greg Monroe,111,54,108,50.0,54,107,50.47,0,1,0.0,44,74,59.46,27,13,31,1.0,8,4.0
Greg Oden,10,7,11,63.64,7,11,63.64,0,0,0.0,1,6,16.67,4,1,6,0.0,2,0.0
Greg Ostertag,2,1,2,50.0,1,2,50.0,0,0,0.0,1,2,50.0,1,0,2,0.0,1,0.0
Greg Smith,5,1,1,100.0,1,1,100.0,0,0,0.0,2,2,100.0,1,0,2,0.0,1,0.0
Greg Stiemsma,2,1,1,100.0,1,1,100.0,0,0,0.0,0,0,0.0,1,0,0,0.0,1,0.0
Greivis Vasquez,61,31,92,33.7,20,45,44.44,11,47,23.4,16,21,76.19,10,2,3,0.0,6,1.0
Gustavo Ayon,13,9,12,75.0,9,12,75.0,0,0,0.0,2,4,50.0,8,2,2,0.0,3,0.0
Ha Seung-Jin,1,1,1,100.0,1,1,100.0,0,0,0.0,0,0,0.0,0,0,1,0.0,1,0.0
Hakim Warrick,51,30,54,55.56,29,49,59.18,1,5,20.0,34,45,75.56,20,5,17,0.0,8,1.0
Hamed Haddadi,4,0,1,0.0,0,1,0.0,0,0,0.0,0,0,0.0,0,0,3,0.0,3,0.0
Harrison Barnes,75,39,98,39.8,31,66,46.97,8,32,25.0,35,44,79.55,18,3,13,0.0,6,2.0
Hassan Whiteside,59,26,42,61.9,26,42,61.9,0,0,0.0,22,37,59.46,19,6,30,0.0,4,1.0
Hedo Turkoglu,164,85,232,36.64,56,126,44.44,29,106,27.36,108,134,80.6,33,10,22,0.0,10,3.0
Henry Ellenson,1,0,0,0.0,0,0,0.0,0,0,0.0,2,2,100.0,0,0,0,,1,0.0
Henry Sims,12,8,12,66.67,7,10,70.0,1,2,50.0,1,2,50.0,5,0,2,0.0,2,0.0
Henry Walker,11,4,11,36.36,1,1,100.0,3,10,30.0,7,8,87.5,4,0,0,0.0,4,0.0
Hilton Armstrong,7,0,3,0.0,0,3,0.0,0,0,0.0,2,4,50.0,0,2,5,0.0,4,0.0
Hollis Thompson,30,16,30,53.33,5,12,41.67,11,18,61.11,6,11,54.55,13,1,2,0.0,4,1.0
Howard Eisley,8,3,13,23.08,2,9,22.22,1,4,25.0,2,2,100.0,1,0,1,0.0,2,0.0
Ian Clark,9,2,5,40.0,2,4,50.0,0,1,0.0,4,4,100.0,1,0,1,0.0,3,0.0
Ian Mahinmi,30,7,14,50.0,7,14,50.0,0,0,0.0,7,21,33.33,5,2,12,0.0,8,0.0
Ike Diogu,7,3,5,60.0,3,5,60.0,0,0,0.0,2,6,33.33,2,0,1,0.0,2,0.0
Iman Shumpert,41,14,32,43.75,8,16,50.0,6,16,37.5,11,17,64.71,6,1,9,0.0,6,0.0
Ime Udoka,33,10,24,41.67,4,11,36.36,6,13,46.15,4,12,33.33,10,0,9,0.0,4,0.0
Ira Newble,8,3,4,75.0,2,3,66.67,1,1,100.0,1,2,50.0,3,0,3,0.0,4,0.0
Isaiah Canaan,23,4,33,12.12,2,14,14.29,2,19,10.53,10,11,90.91,2,5,5,0.0,5,0.0
Isaiah Taylor,6,1,3,33.33,1,2,50.0,0,1,0.0,2,6,33.33,0,0,0,0.0,1,0.0
Isaiah Thomas,127,85,212,40.09,59,136,43.38,26,76,34.21,168,190,88.42,25,25,7,1.0,7,3.0
Isaiah Whitehead,3,1,2,50.0,1,2,50.0,0,0,0.0,1,3,33.33,0,1,0,0.0,1,0.0
Ish Smith,49,35,103,33.98,26,73,35.62,9,30,30.0,12,24,50.0,5,3,9,0.0,6,1.0
Ivan Johnson,8,9,10,90.0,9,10,90.0,0,0,0.0,4,4,100.0,7,0,3,0.0,2,0.0
Ivica Zubac,4,1,1,100.0,1,1,100.0,0,0,0.0,1,2,50.0,1,0,2,0.0,2,0.0
J.J. Barea,15,9,19,47.37,6,8,75.0,3,11,27.27,3,3,100.0,2,1,0,0.0,2,0.0
J.R. Smith,159,82,217,37.79,37,78,47.44,45,139,32.37,72,107,67.29,48,9,21,0.0,12,2.0
JJ Hickson,57,25,48,52.08,25,45,55.56,0,3,0.0,20,31,64.52,17,4,20,0.0,7,1.0
JJ Redick,139,60,147,40.82,30,53,56.6,30,94,31.91,157,169,92.9,43,6,3,1.0,12,3.0
JR Smith,17,6,21,28.57,0,4,0.0,6,17,35.29,3,6,50.0,6,0,1,0.0,2,0.0
JaKarr Sampson,6,3,4,75.0,3,4,75.0,0,0,0.0,6,8,75.0,1,0,1,0.0,2,0.0
JaMychal Green,22,8,16,50.0,6,11,54.55,2,5,40.0,10,17,58.82,4,0,9,0.0,3,0.0
JaVale McGee,39,19,32,59.38,19,31,61.29,0,1,0.0,4,14,28.57,11,1,12,0.0,7,1.0
Jabari Brown,2,1,1,100.0,1,1,100.0,0,0,0.0,0,0,0.0,1,0,0,0.0,1,0.0
Jabari Parker,36,20,49,40.82,18,39,46.15,2,10,20.0,10,16,62.5,12,3,6,0.0,4,1.0
Jabari Smith,3,1,2,50.0,1,2,50.0,0,0,0.0,1,2,50.0,1,0,0,0.0,1,0.0
Jackie Butler,5,2,2,100.0,2,2,100.0,0,0,0.0,7,10,70.0,1,0,2,0.0,1,0.0
Jackson Vroman,1,0,0,0.0,0,0,0.0,0,0,0.0,0,0,0.0,0,0,0,,1,0.0
Jacque Vaughn,14,7,13,53.85,7,11,63.64,0,2,0.0,11,16,68.75,5,1,2,0.0,4,0.0
Jae Crowder,76,27,64,42.19,16,28,57.14,11,36,30.56,33,35,94.29,23,2,9,1.0,6,2.0
Jahlil Okafor,9,4,10,40.0,4,10,40.0,0,0,0.0,1,4,25.0,0,3,1,0.0,2,0.0
Jake Layman,2,3,4,75.0,3,3,100.0,0,1,0.0,0,0,0.0,2,0,0,0.0,2,0.0
Jake Tsakalidis,2,0,1,0.0,0,1,0.0,0,0,0.0,0,0,0.0,0,0,0,0.0,1,0.0
Jake Voskuhl,8,2,6,33.33,2,6,33.33,0,0,0.0,7,13,53.85,0,1,4,0.0,4,0.0
Jakob Poeltl,4,0,0,0.0,0,0,0.0,0,0,0.0,0,1,0.0,0,0,2,,2,0.0
Jalen Jones,2,0,3,0.0,0,0,0.0,0,3,0.0,0,0,0.0,0,1,0,0.0,1,0.0
Jalen Rose,39,22,65,33.85,21,45,46.67,1,20,5.0,42,48,87.5,10,5,2,0.0,2,0.0
Jamaal Magloire,40,11,25,44.0,11,25,44.0,0,0,0.0,14,28,50.0,8,8,14,0.0,6,0.0
Jamaal Tinsley,57,43,105,40.95,35,83,42.17,8,22,36.36,31,47,65.96,8,6,11,1.0,7,0.0
Jamal Crawford,262,164,456,35.96,117,268,43.66,47,188,25.0,224,277,80.87,53,14,22,0.0,14,4.0
Jamal Murray,22,8,29,27.59,5,13,38.46,3,16,18.75,26,27,96.3,3,3,2,0.0,2,0.0
Jamal Sampson,2,0,1,0.0,0,1,0.0,0,0,0.0,2,2,100.0,0,0,1,0.0,1,0.0
Jamario Moon,32,5,22,22.73,4,10,40.0,1,12,8.33,11,14,78.57,4,1,4,0.0,4,0.0
Jameer Nelson,181,114,321,35.51,85,220,38.64,29,101,28.71,92,119,77.31,27,22,23,0.0,14,3.0
James Anderson,17,9,18,50.0,2,5,40.0,7,13,53.85,10,13,76.92,9,1,4,0.0,4,1.0
James Ennis,4,0,2,0.0,0,1,0.0,0,1,0.0,1,1,100.0,0,1,0,0.0,2,0.0
James Ennis III,12,1,5,20.0,1,1,100.0,0,4,0.0,5,7,71.43,1,0,1,0.0,2,0.0
James Harden,185,115,313,36.74,79,180,43.89,36,133,27.07,228,294,77.55,21,32,24,0.0,9,2.0
James Johnson,74,24,68,35.29,15,40,37.5,9,28,32.14,21,30,70.0,17,4,14,0.0,9,0.0
James Jones,47,15,47,31.91,6,20,30.0,9,27,33.33,39,45,86.67,13,1,7,0.0,10,0.0
James Posey,99,28,71,39.44,9,20,45.0,19,51,37.25,55,68,80.88,16,0,11,0.0,7,0.0
James Singleton,12,7,8,87.5,5,5,100.0,2,3,66.67,1,2,50.0,5,0,3,0.0,4,0.0
James Thomas,1,1,2,50.0,1,2,50.0,0,0,0.0,0,0,0.0,1,0,1,0.0,1,0.0
Jamil Wilson,2,1,3,33.33,0,0,0.0,1,3,33.33,0,0,0.0,1,0,0,0.0,1,0.0
Jamison Brewer,2,0,1,0.0,0,1,0.0,0,0,0.0,2,2,100.0,0,0,0,0.0,1,0.0
Jan Vesely,2,0,0,0.0,0,0,0.0,0,0,0.0,0,0,0.0,0,0,1,,1,0.0
Jannero Pargo,40,19,50,38.0,13,31,41.94,6,19,31.58,16,24,66.67,6,5,1,0.0,7,0.0
Jared Cunningham,1,0,0,0.0,0,0,0.0,0,0,0.0,0,1,0.0,0,0,0,,1,0.0
Jared Dudley,86,23,85,27.06,8,25,32.0,15,60,25.0,36,41,87.8,20,2,14,0.0,10,0.0
Jared Jeffries,42,11,28,39.29,10,22,45.45,1,6,16.67,12,20,60.0,7,2,18,0.0,9,0.0
Jared Reiner,2,1,1,100.0,1,1,100.0,0,0,0.0,0,0,0.0,1,0,1,0.0,2,0.0
Jared Sullinger,55,24,74,32.43,14,39,35.9,10,35,28.57,20,30,66.67,15,5,23,0.0,4,0.0
Jarell Martin,14,3,9,33.33,3,5,60.0,0,4,0.0,6,9,66.67,2,1,3,0.0,3,0.0
Jarnell Stokes,1,1,1,100.0,1,1,100.0,0,0,0.0,1,2,50.0,0,0,0,0.0,1,0.0
Jarrett Allen,7,0,3,0.0,0,3,0.0,0,0,0.0,9,10,90.0,0,2,3,0.0,1,0.0
Jarrett Jack,219,122,302,40.4,94,204,46.08,28,98,28.57,217,261,83.14,40,19,11,1.0,12,5.0
Jarron Collins,11,1,1,100.0,1,1,100.0,0,0,0.0,6,11,54.55,1,0,3,0.0,3,0.0
Jarvis Hayes,50,17,50,34.0,4,14,28.57,13,36,36.11,21,27,77.78,15,1,7,0.0,6,0.0
Jason Collins,29,5,9,55.56,5,9,55.56,0,0,0.0,14,31,45.16,3,2,12,0.0,5,0.0
Jason Hart,35,15,42,35.71,12,27,44.44,3,15,20.0,24,32,75.0,3,3,3,0.0,4,0.0
Jason Kapono,48,27,72,37.5,12,25,48.0,15,47,31.91,7,12,58.33,21,2,4,0.0,7,0.0
Jason Kidd,185,55,170,32.35,28,69,40.58,27,101,26.73,119,164,72.56,31,4,18,0.0,9,1.0
Jason Maxiell,46,13,27,48.15,13,27,48.15,0,0,0.0,21,34,61.76,6,2,23,0.0,10,0.0
Jason Richardson,167,110,287,38.33,60,149,40.27,50,138,36.23,97,141,68.79,64,9,28,0.0,10,3.0
Jason Smith,31,8,34,23.53,7,32,21.88,1,2,50.0,12,16,75.0,4,10,11,0.0,8,0.0
Jason Terry,240,152,373,40.75,107,219,48.86,45,154,29.22,188,226,83.19,72,19,17,1.0,14,5.0
Jason Thompson,69,23,58,39.66,23,57,40.35,0,1,0.0,18,34,52.94,12,4,32,0.0,8,1.0
Jason Williams,45,21,49,42.86,13,28,46.43,8,21,38.1,28,37,75.68,8,1,4,0.0,6,0.0
Javaris Crittenton,2,1,2,50.0,1,2,50.0,0,0,0.0,0,0,0.0,0,0,0,0.0,1,0.0
Jawad Williams,3,1,1,100.0,1,1,100.0,0,0,0.0,1,2,50.0,0,0,3,0.0,2,0.0
Jawun Evans,1,0,0,0.0,0,0,0.0,0,0,0.0,1,1,100.0,0,0,0,,1,0.0
Jaylen Brown,15,9,17,52.94,4,8,50.0,5,9,55.56,3,7,42.86,6,2,3,0.0,2,1.0
Jayson Tatum,16,7,17,41.18,5,12,41.67,2,5,40.0,11,15,73.33,7,1,0,0.0,1,1.0
Jeff Adrien,6,3,5,60.0,3,5,60.0,0,0,0.0,2,2,100.0,3,0,1,0.0,2,0.0
Jeff Ayres,5,3,4,75.0,3,3,100.0,0,1,0.0,1,2,50.0,3,0,1,0.0,3,0.0
Jeff Foster,58,9,22,40.91,9,22,40.91,0,0,0.0,15,24,62.5,5,2,35,0.0,7,0.0
Jeff Green,181,96,232,41.38,65,137,47.45,31,95,32.63,99,118,83.9,53,19,34,1.0,10,4.0
Jeff McInnis,20,8,26,30.77,6,14,42.86,2,12,16.67,14,19,73.68,6,1,3,0.0,4,0.0
Jeff Taylor,9,2,4,50.0,1,1,100.0,1,3,33.33,1,2,50.0,2,0,0,0.0,2,0.0
Jeff Teague,134,80,181,44.2,69,140,49.29,11,41,26.83,132,157,84.08,16,21,7,1.0,8,5.0
Jeff Withey,9,3,7,42.86,3,7,42.86,0,0,0.0,1,2,50.0,2,3,2,0.0,4,0.0
Jerami Grant,28,5,13,38.46,4,9,44.44,1,4,25.0,9,20,45.0,3,1,5,0.0,4,0.0
Jeremy Evans,5,3,5,60.0,3,5,60.0,0,0,0.0,2,3,66.67,3,0,3,0.0,4,0.0
Jeremy Lamb,34,11,31,35.48,8,15,53.33,3,16,18.75,17,19,89.47,7,1,3,0.0,5,0.0
Jeremy Lin,74,53,110,48.18,35,74,47.3,18,36,50.0,78,92,84.78,20,11,6,1.0,6,4.0
Jeremy Pargo,3,3,10,30.0,1,5,20.0,2,5,40.0,3,3,100.0,1,2,0,0.0,2,0.0
Jeremy Richardson,1,0,1,0.0,0,1,0.0,0,0,0.0,0,0,0.0,0,0,0,0.0,1,0.0
Jerian Grant,12,5,15,33.33,4,8,50.0,1,7,14.29,19,24,79.17,1,1,2,0.0,3,0.0
Jermaine Jackson,1,0,0,0.0,0,0,0.0,0,0,0.0,0,0,0.0,0,0,0,,1,0.0
Jermaine O'Neal,117,56,148,37.84,55,145,37.93,1,3,33.33,53,77,68.83,31,16,35,0.0,10,2.0
Jermaine Taylor,3,5,5,100.0,5,5,100.0,0,0,0.0,0,0,0.0,1,0,1,0.0,1,0.0
Jerome James,4,1,2,50.0,1,2,50.0,0,0,0.0,1,2,50.0,1,0,0,0.0,2,0.0
Jerome Moiso,1,0,1,0.0,0,1,0.0,0,0,0.0,0,0,0.0,0,1,0,0.0,1,0.0
Jerome Williams,10,3,5,60.0,3,5,60.0,0,0,0.0,4,5,80.0,2,1,2,0.0,1,0.0
Jerry Stackhouse,60,20,52,38.46,13,32,40.62,7,20,35.0,56,68,82.35,10,6,7,0.0,8,0.0
Jerryd Bayless,84,29,89,32.58,22,67,32.84,7,22,31.82,90,115,78.26,12,7,6,0.0,10,0.0
Jim Jackson,17,9,31,29.03,8,16,50.0,1,15,6.67,2,2,100.0,6,1,2,0.0,2,0.0
Jimmer Fredette,15,4,14,28.57,3,6,50.0,1,8,12.5,16,17,94.12,2,0,1,0.0,4,0.0
Jimmy Butler,125,88,213,41.31,57,134,42.54,31,79,39.24,139,161,86.34,37,8,21,1.0,7,4.0
Jiri Welsch,6,1,6,16.67,0,4,0.0,1,2,50.0,6,8,75.0,1,1,1,0.0,2,0.0
Joakim Noah,121,41,95,43.16,41,94,43.62,0,1,0.0,47,76,61.84,23,8,72,1.0,10,1.0
Jodie Meeks,62,27,62,43.55,11,17,64.71,16,45,35.56,30,38,78.95,24,3,1,0.0,8,1.0
Joe Alexander,3,1,4,25.0,1,2,50.0,0,2,0.0,0,0,0.0,0,0,1,0.0,1,0.0
Joe Harris,16,5,18,27.78,3,6,50.0,2,12,16.67,4,6,66.67,4,3,5,0.0,3,0.0
Joe Ingles,37,13,33,39.39,2,5,40.0,11,28,39.29,8,13,61.54,11,1,4,0.0,4,1.0
Joe Johnson,309,237,604,39.24,164,398,41.21,73,206,35.44,221,267,82.77,80,30,23,0.0,14,5.0
Joe Smith,60,32,68,47.06,32,68,47.06,0,0,0.0,46,57,80.7,26,6,25,1.0,5,1.0
Joel Anthony,14,0,2,0.0,0,2,0.0,0,0,0.0,6,7,85.71,0,1,4,0.0,8,0.0
Joel Bolomboy,1,0,0,0.0,0,0,0.0,0,0,0.0,0,0,0.0,0,0,1,,1,0.0
Joel Embiid,25,17,42,40.48,14,32,43.75,3,10,30.0,36,38,94.74,12,7,8,0.0,2,1.0
Joel Freeland,3,1,2,50.0,1,2,50.0,0,0,0.0,1,2,50.0,1,0,1,0.0,1,0.0
Joel Przybilla,25,6,6,100.0,6,6,100.0,0,0,0.0,8,12,66.67,3,0,16,0.0,7,0.0
Joey Dorsey,1,0,0,0.0,0,0,0.0,0,0,0.0,0,0,0.0,0,0,0,,1,0.0
Joey Graham,15,3,15,20.0,2,13,15.38,1,2,50.0,4,8,50.0,3,4,4,0.0,5,0.0
Joffrey Lauvergne,6,0,2,0.0,0,1,0.0,0,1,0.0,1,2,50.0,0,0,4,0.0,2,0.0
Johan Petro,13,4,8,50.0,4,8,50.0,0,0,0.0,1,4,25.0,3,0,5,0.0,6,0.0
John Collins,10,3,5,60.0,2,2,100.0,1,3,33.33,3,4,75.0,3,1,1,0.0,1,0.0
John Henson,43,9,27,33.33,9,26,34.62,0,1,0.0,11,13,84.62,5,1,14,0.0,6,0.0
John Jenkins,5,0,6,0.0,0,3,0.0,0,3,0.0,5,6,83.33,0,0,2,0.0,3,0.0
John Lucas III,14,6,15,40.0,4,9,44.44,2,6,33.33,3,5,60.0,2,0,4,0.0,7,0.0
John Salmons,157,86,185,46.49,58,110,52.73,28,75,37.33,121,150,80.67,37,16,27,1.0,10,4.0
John Wall,193,154,398,38.69,129,301,42.86,25,97,25.77,236,307,76.87,22,21,12,0.0,8,3.0
Johnathan Motley,1,2,2,100.0,1,1,100.0,1,1,100.0,0,0,0.0,2,0,1,0.0,1,0.0
Johnny O'Bryant,1,1,1,100.0,1,1,100.0,0,0,0.0,0,0,0.0,1,0,1,0.0,1,0.0
Jon Barry,7,1,8,12.5,0,1,0.0,1,7,14.29,8,11,72.73,1,0,0,0.0,2,0.0
Jon Brockman,7,0,1,0.0,0,1,0.0,0,0,0.0,1,2,50.0,0,0,4,0.0,2,0.0
Jon Leuer,18,6,18,33.33,5,11,45.45,1,7,14.29,7,9,77.78,4,3,4,0.0,4,0.0
Jonas Jerebko,37,12,31,38.71,11,22,50.0,1,9,11.11,10,13,76.92,6,2,12,0.0,7,0.0
Jonas Valanciunas,59,21,33,63.64,21,31,67.74,0,2,0.0,38,48,79.17,15,3,22,0.0,6,0.0
Jonathan Gibson,2,2,3,66.67,1,1,100.0,1,2,50.0,0,0,0.0,2,0,0,0.0,2,0.0
Jonathan Isaac,1,0,0,0.0,0,0,0.0,0,0,0.0,0,0,0.0,0,0,0,,1,0.0
Jonathon Simmons,16,6,14,42.86,4,9,44.44,2,5,40.0,4,7,57.14,5,0,3,0.0,3,0.0
Jonny Flynn,20,11,34,32.35,10,27,37.04,1,7,14.29,14,18,77.78,1,2,1,0.0,3,0.0
Jordan Adams,1,1,2,50.0,0,0,0.0,1,2,50.0,0,0,0.0,1,0,0,0.0,1,0.0
Jordan Bell,2,0,0,0.0,0,0,0.0,0,0,0.0,0,0,0.0,0,0,0,,1,0.0
Jordan Clarkson,48,37,74,50.0,26,49,53.06,11,25,44.0,41,46,89.13,15,3,10,1.0,4,2.0
Jordan Crawford,51,32,82,39.02,25,47,53.19,7,35,20.0,27,38,71.05,6,1,6,0.0,5,1.0
Jordan Farmar,42,29,67,43.28,14,31,45.16,15,36,41.67,22,27,81.48,11,1,6,1.0,9,0.0
Jordan Hamilton,6,2,7,28.57,2,5,40.0,0,2,0.0,1,1,100.0,1,1,2,0.0,4,0.0
Jordan Hill,43,27,52,51.92,27,50,54.0,0,2,0.0,17,21,80.95,17,2,22,0.0,7,1.0
Jordan McRae,1,3,5,60.0,2,4,50.0,1,1,100.0,1,3,33.33,0,2,0,0.0,1,0.0
Jorge Garbajosa,10,4,6,66.67,3,3,100.0,1,3,33.33,1,2,50.0,4,0,2,0.0,2,0.0
Jorge Gutierrez,1,0,0,0.0,0,0,0.0,0,0,0.0,0,0,0.0,0,0,0,,1,0.0
Jose Calderon,138,64,148,43.24,41,76,53.95,23,72,31.94,70,81,86.42,22,8,8,1.0,12,4.0
Jose Juan Barea,69,39,102,38.24,28,63,44.44,11,39,28.21,26,37,70.27,9,7,6,0.0,9,1.0
Josh Boone,15,10,16,62.5,10,16,62.5,0,0,0.0,3,7,42.86,7,1,5,0.0,4,0.0
Josh Childress,57,26,44,59.09,23,34,67.65,3,10,30.0,26,34,76.47,16,6,25,0.0,5,1.0
Josh Davis,3,1,1,100.0,0,0,0.0,1,1,100.0,1,2,50.0,1,0,0,0.0,1,0.0
Josh Hart,11,2,8,25.0,1,3,33.33,1,5,20.0,6,13,46.15,2,1,4,0.0,1,0.0
Josh Howard,71,27,60,45.0,24,45,53.33,3,15,20.0,29,41,70.73,18,0,21,0.0,8,0.0
Josh Huestis,1,0,0,0.0,0,0,0.0,0,0,0.0,0,0,0.0,0,0,1,,1,0.0
Josh Jackson,5,2,5,40.0,2,3,66.67,0,2,0.0,1,1,100.0,1,0,0,0.0,1,0.0
Josh McRoberts,40,12,31,38.71,11,19,57.89,1,12,8.33,19,25,76.0,8,3,14,0.0,7,0.0
Josh Powell,5,3,6,50.0,3,6,50.0,0,0,0.0,2,2,100.0,3,0,3,0.0,3,0.0
Josh Richardson,38,14,32,43.75,9,17,52.94,5,15,33.33,22,24,91.67,8,1,6,0.0,3,1.0
Josh Smith,225,129,304,42.43,102,225,45.33,27,79,34.18,88,142,61.97,75,20,87,1.0,12,7.0
Jrue Holiday,150,87,224,38.84,64,151,42.38,23,73,31.51,86,116,74.14,18,18,15,0.0,9,4.0
Juan Carlos Navarro,15,6,14,42.86,2,5,40.0,4,9,44.44,14,19,73.68,5,0,1,0.0,1,1.0
Juan Dixon,52,25,70,35.71,19,41,46.34,6,29,20.69,35,37,94.59,12,1,0,0.0,5,1.0
Juan Hernangomez,1,0,0,0.0,0,0,0.0,0,0,0.0,0,0,0.0,0,0,1,,1,0.0
Julian Wright,4,1,1,100.0,1,1,100.0,0,0,0.0,0,2,0.0,0,0,0,0.0,3,0.0
Julius Randle,48,21,35,60.0,19,28,67.86,2,7,28.57,33,55,60.0,6,7,14,0.0,3,2.0
Julyan Stone,1,0,1,0.0,0,1,0.0,0,0,0.0,1,2,50.0,0,1,0,0.0,1,0.0
Jumaine Jones,30,6,30,20.0,3,12,25.0,3,18,16.67,11,18,61.11,3,1,6,0.0,2,0.0
Junior Harrington,2,6,9,66.67,4,7,57.14,2,2,100.0,0,0,0.0,2,0,0,0.0,2,0.0
Justin Anderson,4,2,3,66.67,2,2,100.0,0,1,0.0,1,4,25.0,2,0,0,0.0,3,0.0
Justin Hamilton,8,2,5,40.0,0,0,0.0,2,5,40.0,4,4,100.0,2,0,1,0.0,2,0.0
Justin Holiday,27,9,27,33.33,2,7,28.57,7,20,35.0,16,19,84.21,9,2,1,0.0,4,0.0
Justin Jackson,1,0,1,0.0,0,0,0.0,0,1,0.0,0,0,0.0,0,0,0,0.0,1,0.0
Justin Reed,6,1,4,25.0,1,4,25.0,0,0,0.0,1,2,50.0,1,1,1,0.0,3,0.0
Justin Williams,2,0,0,0.0,0,0,0.0,0,0,0.0,0,0,0.0,0,0,0,,2,0.0
Justise Winslow,31,11,28,39.29,10,22,45.45,1,6,16.67,11,18,61.11,5,2,6,0.0,3,0.0
Jusuf Nurkic,28,7,14,50.0,7,13,53.85,0,1,0.0,20,31,64.52,3,2,9,0.0,4,0.0
Juwan Howard,43,19,39,48.72,19,39,48.72,0,0,0.0,15,18,83.33,12,4,18,0.0,5,0.0
KJ McDaniels,5,3,9,33.33,2,6,33.33,1,3,33.33,0,0,0.0,1,0,1,0.0,1,0.0
Kareem Rush,16,12,25,48.0,8,14,57.14,4,11,36.36,0,2,0.0,9,0,1,0.0,4,0.0
Karl-Anthony Towns,80,45,103,43.69,35,65,53.85,10,38,26.32,29,36,80.56,33,6,27,1.0,3,2.0
Kasib Powell,1,0,1,0.0,0,0,0.0,0,1,0.0,0,0,0.0,0,0,0,0.0,1,0.0
Kawhi Leonard,76,42,122,34.43,33,86,38.37,9,36,25.0,60,75,80.0,18,6,19,0.0,6,1.0
Keith Bogans,55,22,61,36.07,15,36,41.67,7,25,28.0,12,23,52.17,16,10,5,0.0,9,0.0
Keith McLeod,17,13,26,50.0,10,21,47.62,3,5,60.0,14,20,70.0,2,1,1,0.0,3,0.0
Keith Van Horn,14,7,11,63.64,4,5,80.0,3,6,50.0,11,13,84.62,6,1,5,0.0,2,0.0
Kelenna Azubuike,27,18,32,56.25,13,23,56.52,5,9,55.56,20,24,83.33,10,0,8,0.0,4,0.0
Kelly Olynyk,42,15,47,31.91,10,23,43.48,5,24,20.83,27,35,77.14,11,2,10,0.0,5,0.0
Kelly Oubre Jr.,18,4,14,28.57,2,6,33.33,2,8,25.0,5,7,71.43,2,2,6,0.0,2,0.0
Kelvin Cato,11,2,2,100.0,2,2,100.0,0,0,0.0,6,8,75.0,2,0,2,0.0,2,0.0
Kemba Walker,156,133,366,36.34,100,239,41.84,33,127,25.98,171,213,80.28,26,32,28,0.0,7,1.0
Kendall Gill,2,1,2,50.0,0,0,0.0,1,2,50.0,0,0,0.0,1,0,0,0.0,1,0.0
Kendall Marshall,9,1,6,16.67,0,1,0.0,1,5,20.0,0,2,0.0,1,1,0,0.0,4,0.0
Kendrick Perkins,73,12,32,37.5,12,32,37.5,0,0,0.0,15,33,45.45,6,4,26,0.0,12,0.0
Kenneth Faried,77,38,69,55.07,38,67,56.72,0,2,0.0,44,89,49.44,23,7,50,1.0,7,2.0
Kenny Thomas,30,16,27,59.26,16,27,59.26,0,0,0.0,20,25,80.0,10,0,8,0.0,4,1.0
Kent Bazemore,62,29,59,49.15,17,33,51.52,12,26,46.15,34,46,73.91,18,3,9,0.0,6,3.0
Kentavious Caldwell-Pope,83,48,129,37.21,15,29,51.72,33,100,33.0,24,42,57.14,34,4,7,0.0,5,2.0
Kenyon Martin,94,47,85,55.29,46,75,61.33,1,10,10.0,19,30,63.33,25,3,32,1.0,10,3.0
Kerry Kittles,4,4,6,66.67,3,5,60.0,1,1,100.0,1,2,50.0,3,0,0,0.0,1,0.0
Kevin Burleson,1,0,0,0.0,0,0,0.0,0,0,0.0,0,0,0.0,0,0,0,,1,0.0
Kevin Durant,257,222,589,37.69,153,383,39.95,69,206,33.5,294,344,85.47,103,14,16,0.0,11,2.0
Kevin Garnett,239,137,368,37.23,131,342,38.3,6,26,23.08,146,184,79.35,90,13,55,0.0,12,3.0
Kevin Jones,1,0,1,0.0,0,1,0.0,0,0,0.0,0,0,0.0,0,0,0,0.0,1,0.0
Kevin Love,141,77,201,38.31,45,109,41.28,32,92,34.78,103,127,81.1,52,19,50,0.0,10,3.0
Kevin Martin,175,104,266,39.1,78,188,41.49,26,78,33.33,199,231,86.15,64,23,15,0.0,12,4.0
Kevin Ollie,6,0,5,0.0,0,4,0.0,0,1,0.0,7,8,87.5,0,1,1,0.0,4,0.0
Kevin Seraphin,19,10,24,41.67,10,24,41.67,0,0,0.0,2,2,100.0,8,0,5,0.0,7,0.0
Kevin Willis,2,0,1,0.0,0,1,0.0,0,0,0.0,0,0,0.0,0,0,1,0.0,1,0.0
Kevon Looney,2,0,0,0.0,0,0,0.0,0,0,0.0,0,0,0.0,0,0,0,,1,0.0
Keyon Dooling,68,28,81,34.57,20,47,42.55,8,34,23.53,34,42,80.95,12,7,5,0.0,8,1.0
Khem Birch,1,1,1,100.0,1,1,100.0,0,0,0.0,2,2,100.0,1,0,0,0.0,1,0.0
Khris Middleton,107,64,169,37.87,37,89,41.57,27,80,33.75,92,104,88.46,39,10,9,0.0,6,3.0
Kim English,1,0,0,0.0,0,0,0.0,0,0,0.0,1,2,50.0,0,0,0,,1,0.0
Kirk Hinrich,162,70,208,33.65,57,148,38.51,13,60,21.67,98,135,72.59,31,17,11,0.0,12,1.0
Kirk Snyder,15,6,17,35.29,5,13,38.46,1,4,25.0,6,9,66.67,5,2,1,0.0,4,0.0
Klay Thompson,114,53,157,33.76,24,61,39.34,29,96,30.21,48,54,88.89,43,7,4,0.0,7,2.0
Kobe Bryant,289,290,780,37.18,214,514,41.63,76,266,28.57,379,453,83.66,73,27,29,0.0,12,3.0
Kobi Simmons,2,2,2,100.0,2,2,100.0,0,0,0.0,0,0,0.0,1,0,0,0.0,1,0.0
Kosta Koufos,19,10,14,71.43,10,14,71.43,0,0,0.0,2,6,33.33,6,0,9,0.0,6,0.0
Kostas Papanikolaou,2,0,1,0.0,0,0,0.0,0,1,0.0,0,0,0.0,0,0,0,0.0,1,0.0
Kris Dunn,21,10,26,38.46,10,24,41.67,0,2,0.0,13,22,59.09,0,5,2,0.0,2,1.0
Kris Humphries,67,33,67,49.25,32,66,48.48,1,1,100.0,15,27,55.56,24,9,31,1.0,13,2.0
Kristaps Porzingis,44,28,64,43.75,20,41,48.78,8,23,34.78,33,41,80.49,19,1,12,1.0,3,1.0
Kurt Thomas,76,30,66,45.45,29,64,45.31,1,2,50.0,23,40,57.5,14,5,32,1.0,7,1.0
Kwame Brown,36,9,18,50.0,9,17,52.94,0,1,0.0,13,26,50.0,6,4,14,0.0,7,0.0
Kyle Anderson,14,3,6,50.0,2,4,50.0,1,2,50.0,9,12,75.0,1,1,4,0.0,4,0.0
Kyle Collinsworth,1,1,1,100.0,1,1,100.0,0,0,0.0,0,0,0.0,0,0,1,0.0,1,0.0
Kyle Korver,221,85,202,42.08,28,58,48.28,57,144,39.58,187,212,88.21,71,6,14,1.0,14,2.0
Kyle Kuzma,16,9,28,32.14,5,12,41.67,4,16,25.0,3,6,50.0,5,3,2,0.0,1,0.0
Kyle Lowry,236,132,388,34.02,83,226,36.73,49,162,30.25,200,262,76.34,40,40,39,0.0,12,1.0
Kyle O'Quinn,18,7,14,50.0,7,13,53.85,0,1,0.0,8,11,72.73,5,1,7,0.0,6,0.0
Kyle Singler,27,5,22,22.73,2,9,22.22,3,13,23.08,12,15,80.0,4,4,4,0.0,5,0.0
Kyle Weaver,2,0,1,0.0,0,0,0.0,0,1,0.0,0,0,0.0,0,0,1,0.0,1,0.0
Kyrie Irving,126,137,315,43.49,96,210,45.71,41,105,39.05,178,201,88.56,28,29,10,1.0,7,4.0
Kyrylo Fesenko,3,5,6,83.33,5,6,83.33,0,0,0.0,1,5,20.0,4,0,0,0.0,3,0.0
LaMarcus Aldridge,255,135,357,37.82,131,340,38.53,4,17,23.53,152,217,70.05,69,24,111,0.0,12,6.0
Lamar Odom,149,58,148,39.19,44,98,44.9,14,50,28.0,58,97,59.79,31,13,50,0.0,8,4.0
Lamar Patterson,1,0,0,0.0,0,0,0.0,0,0,0.0,1,2,50.0,0,0,0,,1,0.0
Lamond Murray,6,2,5,40.0,1,1,100.0,1,4,25.0,0,0,0.0,2,0,1,0.0,2,0.0
Lance Stephenson,55,28,68,41.18,18,38,47.37,10,30,33.33,17,23,73.91,15,5,15,1.0,6,0.0
Lance Thomas,28,9,22,40.91,7,18,38.89,2,4,50.0,14,15,93.33,6,2,7,0.0,6,0.0
Landry Fields,23,12,20,60.0,8,12,66.67,4,8,50.0,7,12,58.33,8,1,6,0.0,4,0.0
Langston Galloway,42,22,56,39.29,6,17,35.29,16,39,41.03,10,14,71.43,11,2,6,0.0,4,1.0
Laron Profit,3,2,3,66.67,1,1,100.0,1,2,50.0,2,2,100.0,1,0,1,0.0,2,0.0
Larry Hughes,95,40,91,43.96,32,65,49.23,8,26,30.77,85,110,77.27,19,10,10,1.0,7,2.0
Larry Nance Jr.,18,4,7,57.14,3,6,50.0,1,1,100.0,8,10,80.0,3,1,6,0.0,3,0.0
Larry Owens,1,0,0,0.0,0,0,0.0,0,0,0.0,0,0,0.0,0,0,0,,1,0.0
Larry Sanders,25,15,29,51.72,15,28,53.57,0,1,0.0,4,8,50.0,9,2,11,0.0,5,1.0
Latrell Sprewell,17,5,17,29.41,4,12,33.33,1,5,20.0,4,5,80.0,4,0,1,0.0,1,0.0
Lauri Markkanen,18,11,31,35.48,5,11,45.45,6,20,30.0,14,15,93.33,9,3,1,0.0,1,0.0
Lavoy Allen,26,7,15,46.67,7,15,46.67,0,0,0.0,3,4,75.0,6,1,3,0.0,6,0.0
Lawrence Roberts,5,3,5,60.0,3,5,60.0,0,0,0.0,4,4,100.0,2,0,3,0.0,2,0.0
LeBron James,358,338,770,43.9,260,496,52.42,78,274,28.47,453,615,73.66,80,44,52,1.0,14,11.0
Leandro Barbosa,90,46,127,36.22,24,61,39.34,22,66,33.33,24,31,77.42,33,11,5,0.0,13,0.0
Lee Nailon,16,10,27,37.04,10,27,37.04,0,0,0.0,6,6,100.0,7,7,1,0.0,1,0.0
Leon Powe,9,6,8,75.0,6,8,75.0,0,0,0.0,1,5,20.0,4,0,4,0.0,4,0.0
Lester Hudson,3,4,10,40.0,3,4,75.0,1,6,16.67,5,5,100.0,2,0,0,0.0,1,0.0
Linas Kleiza,40,25,55,45.45,15,25,60.0,10,30,33.33,23,24,95.83,19,3,4,0.0,7,1.0
Lindsey Hunter,12,7,13,53.85,3,6,50.0,4,7,57.14,0,0,0.0,4,0,4,0.0,4,0.0
Linton Johnson,5,2,4,50.0,2,3,66.67,0,1,0.0,2,3,66.67,1,1,4,0.0,2,0.0
Lionel Chalmers,1,0,1,0.0,0,0,0.0,0,1,0.0,0,0,0.0,0,0,0,0.0,1,0.0
Lonny Baxter,1,0,1,0.0,0,1,0.0,0,0,0.0,0,0,0.0,0,0,0,0.0,1,0.0
Lonzo Ball,16,8,22,36.36,2,5,40.0,6,17,35.29,2,5,40.0,4,2,3,0.0,1,0.0
Lorenzen Wright,19,4,15,26.67,4,15,26.67,0,0,0.0,6,11,54.55,3,2,12,0.0,4,0.0
Lorenzo Brown,2,1,1,100.0,1,1,100.0,0,0,0.0,1,2,50.0,0,0,0,0.0,1,0.0
Lou Amundson,10,5,8,62.5,5,8,62.5,0,0,0.0,7,9,77.78,3,0,6,0.0,7,0.0
Lou Williams,163,102,275,37.09,60,136,44.12,42,139,30.22,112,130,86.15,37,13,12,0.0,11,4.0
Luc Mbah a Moute,69,15,47,31.91,15,41,36.59,0,6,0.0,30,44,68.18,10,6,27,0.0,10,0.0
Lucas Nogueira,5,0,0,0.0,0,0,0.0,0,0,0.0,0,0,0.0,0,0,1,,2,0.0
Lucious Harris,4,2,4,50.0,1,2,50.0,1,2,50.0,0,0,0.0,2,0,0,0.0,1,0.0
Luis Scola,98,67,128,52.34,67,122,54.92,0,6,0.0,38,52,73.08,44,9,27,1.0,10,3.0
Luke Babbitt,21,7,20,35.0,3,12,25.0,4,8,50.0,6,7,85.71,5,1,7,0.0,6,0.0
Luke Harangody,3,0,0,0.0,0,0,0.0,0,0,0.0,4,4,100.0,0,0,1,,1,0.0
Luke Jackson,3,5,5,100.0,4,4,100.0,1,1,100.0,1,2,50.0,2,0,0,0.0,2,0.0
Luke Kennard,3,0,3,0.0,0,0,0.0,0,3,0.0,2,2,100.0,0,0,1,0.0,1,0.0
Luke Kornet,1,0,1,0.0,0,1,0.0,0,0,0.0,0,0,0.0,0,0,0,0.0,1,0.0
Luke Ridnour,145,62,180,34.44,51,124,41.13,11,56,19.64,115,138,83.33,17,7,8,0.0,11,3.0
Luke Walton,40,15,31,48.39,12,23,52.17,3,8,37.5,17,22,77.27,12,4,13,0.0,6,0.0
Luol Deng,212,88,237,37.13,68,167,40.72,20,70,28.57,108,157,68.79,60,16,50,0.0,13,4.0
Luther Head,57,21,61,34.43,10,29,34.48,11,32,34.38,25,31,80.65,13,10,4,0.0,4,1.0
Maciej Lampe,1,0,1,0.0,0,1,0.0,0,0,0.0,0,0,0.0,0,0,0,0.0,1,0.0
Malcolm Brogdon,12,4,8,50.0,3,5,60.0,1,3,33.33,7,8,87.5,2,1,1,0.0,2,0.0
Malcolm Delaney,7,2,7,28.57,1,3,33.33,1,4,25.0,3,4,75.0,1,0,0,0.0,2,0.0
Malcolm Lee,1,1,1,100.0,1,1,100.0,0,0,0.0,2,2,100.0,0,0,0,0.0,2,0.0
Malcolm Thomas,1,1,1,100.0,1,1,100.0,0,0,0.0,0,0,0.0,1,0,0,0.0,1,0.0
Malik Allen,12,5,15,33.33,5,15,33.33,0,0,0.0,1,3,33.33,3,0,4,0.0,5,0.0
Malik Beasley,1,0,0,0.0,0,0,0.0,0,0,0.0,2,4,50.0,0,0,0,,1,0.0
Malik Hairston,2,1,1,100.0,1,1,100.0,0,0,0.0,0,0,0.0,1,0,1,0.0,1,0.0
Malik Monk,3,0,4,0.0,0,0,0.0,0,4,0.0,3,3,100.0,0,0,0,0.0,1,0.0
Malik Rose,27,5,14,35.71,5,14,35.71,0,0,0.0,17,25,68.0,4,2,1,0.0,4,0.0
Manny Harris,3,0,2,0.0,0,1,0.0,0,1,0.0,0,0,0.0,0,0,1,0.0,2,0.0
Manu Ginobili,215,105,285,36.84,76,170,44.71,29,115,25.22,266,327,81.35,47,17,24,0.0,14,2.0
MarShon Brooks,14,3,9,33.33,2,8,25.0,1,1,100.0,6,8,75.0,0,2,2,0.0,4,0.0
Marc Gasol,204,90,218,41.28,85,189,44.97,5,29,17.24,132,181,72.93,64,14,63,1.0,10,5.0
Marc Jackson,32,11,40,27.5,11,39,28.21,0,1,0.0,15,22,68.18,7,3,14,0.0,3,0.0
Marcelo Huertas,2,0,0,0.0,0,0,0.0,0,0,0.0,0,0,0.0,0,0,1,,1,0.0
Marcin Gortat,120,53,101,52.48,53,100,53.0,0,1,0.0,51,73,69.86,39,12,50,1.0,10,2.0
Marco Belinelli,117,55,145,37.93,29,59,49.15,26,86,30.23,63,72,87.5,40,4,8,0.0,10,1.0
Marcus Banks,17,14,26,53.85,13,21,61.9,1,5,20.0,9,10,90.0,5,1,3,0.0,3,1.0
Marcus Camby,107,30,70,42.86,30,65,46.15,0,5,0.0,27,38,71.05,14,2,49,1.0,9,0.0
Marcus Fizer,4,0,2,0.0,0,2,0.0,0,0,0.0,4,4,100.0,0,0,0,0.0,1,0.0
Marcus Georges-Hunt,2,0,1,0.0,0,1,0.0,0,0,0.0,6,8,75.0,0,0,0,0.0,2,0.0
Marcus Morris,76,30,91,32.97,18,48,37.5,12,43,27.91,24,40,60.0,15,4,12,0.0,7,0.0
Marcus Paige,1,0,1,0.0,0,0,0.0,0,1,0.0,0,0,0.0,0,0,0,0.0,1,0.0
Marcus Smart,57,20,53,37.74,9,20,45.0,11,33,33.33,31,39,79.49,14,2,19,0.0,4,1.0
Marcus Thornton,79,56,135,41.48,26,62,41.94,30,73,41.1,44,53,83.02,36,11,11,1.0,8,2.0
Marcus Williams,12,6,19,31.58,6,15,40.0,0,4,0.0,10,13,76.92,1,2,2,0.0,3,0.0
Mardy Collins,15,1,7,14.29,1,6,16.67,0,1,0.0,4,10,40.0,0,0,3,0.0,4,0.0
Mario Chalmers,89,37,102,36.27,27,47,57.45,10,55,18.18,51,65,78.46,10,3,12,0.0,9,1.0
Mario Hezonja,11,5,17,29.41,2,6,33.33,3,11,27.27,1,2,50.0,2,0,1,0.0,2,0.0
Mario West,4,1,1,100.0,1,1,100.0,0,0,0.0,4,6,66.67,0,0,0,0.0,3,0.0
Mark Blount,58,33,80,41.25,27,67,40.3,6,13,46.15,22,26,84.62,27,7,15,1.0,5,2.0
Mark Madsen,2,0,7,0.0,0,2,0.0,0,5,0.0,0,0,0.0,0,0,1,0.0,2,0.0
Markel Brown,5,3,6,50.0,3,4,75.0,0,2,0.0,2,2,100.0,2,0,1,0.0,2,0.0
Markieff Morris,96,57,122,46.72,45,86,52.33,12,36,33.33,39,56,69.64,36,4,21,1.0,7,3.0
Marko Jaric,48,15,53,28.3,12,40,30.0,3,13,23.08,20,31,64.52,9,4,12,0.0,4,0.0
Marquese Chriss,12,6,10,60.0,4,8,50.0,2,2,100.0,1,6,16.67,4,1,3,0.0,2,0.0
Marquis Daniels,56,25,72,34.72,23,55,41.82,2,17,11.76,18,28,64.29,10,8,13,0.0,9,0.0
Marquis Teague,2,1,3,33.33,1,2,50.0,0,1,0.0,0,0,0.0,0,0,0,0.0,2,0.0
Marreese Speights,34,16,39,41.03,15,35,42.86,1,4,25.0,12,16,75.0,8,3,19,0.0,10,0.0
Martell Webster,81,38,95,40.0,18,39,46.15,20,56,35.71,21,27,77.78,30,5,9,0.0,9,2.0
Marvin Williams,177,65,152,42.76,42,84,50.0,23,68,33.82,75,101,74.26,56,6,46,1.0,13,2.0
Mason Plumlee,35,13,23,56.52,13,21,61.9,0,2,0.0,16,24,66.67,10,2,8,0.0,5,0.0
Mateen Cleaves,1,0,0,0.0,0,0,0.0,0,0,0.0,0,0,0.0,0,0,0,,1,0.0
Matt Barnes,138,37,100,37.0,20,45,44.44,17,55,30.91,54,76,71.05,21,7,30,0.0,13,0.0
Matt Bonner,57,20,51,39.22,13,27,48.15,7,24,29.17,6,10,60.0,15,1,11,0.0,11,1.0
Matt Carroll,54,26,70,37.14,17,39,43.59,9,31,29.03,39,45,86.67,18,8,4,0.0,7,1.0
Matt Freije,2,0,3,0.0,0,1,0.0,0,2,0.0,0,1,0.0,0,1,0,0.0,1,0.0
Matt Harpring,56,26,54,48.15,23,44,52.27,3,10,30.0,39,51,76.47,21,3,18,0.0,5,1.0
Matthew Dellavedova,35,6,33,18.18,1,12,8.33,5,21,23.81,15,21,71.43,5,2,4,0.0,5,0.0
Maurice Evans,37,14,40,35.0,8,20,40.0,6,20,30.0,18,21,85.71,10,3,7,0.0,7,0.0
Maurice Harkless,33,11,20,55.0,11,16,68.75,0,4,0.0,6,10,60.0,6,2,19,0.0,5,0.0
Maurice Ndour,1,1,1,100.0,1,1,100.0,0,0,0.0,0,0,0.0,0,0,0,0.0,1,0.0
Maurice Taylor,14,6,18,33.33,6,18,33.33,0,0,0.0,4,5,80.0,5,2,2,0.0,3,0.0
Maxi Kleber,6,1,4,25.0,1,3,33.33,0,1,0.0,1,2,50.0,1,0,1,0.0,1,0.0
Mehmet Okur,108,64,149,42.95,32,65,49.23,32,84,38.1,76,87,87.36,48,5,23,1.0,7,2.0
Melvin Ely,15,10,16,62.5,10,15,66.67,0,1,0.0,3,9,33.33,5,0,5,0.0,4,0.0
Melvin Sanders,1,1,1,100.0,1,1,100.0,0,0,0.0,0,0,0.0,0,0,0,0.0,1,0.0
Metta World Peace,140,68,201,33.83,44,118,37.29,24,83,28.92,62,84,73.81,22,12,26,0.0,12,2.0
Meyers Leonard,15,4,13,30.77,4,8,50.0,0,5,0.0,12,13,92.31,3,1,4,0.0,4,0.0
Michael Beasley,87,64,146,43.84,55,118,46.61,9,28,32.14,39,50,78.0,23,12,23,1.0,10,2.0
Michael Carter-Williams,56,35,85,41.18,30,74,40.54,5,11,45.45,38,58,65.52,9,6,11,1.0,5,2.0
Michael Curry,1,1,1,100.0,1,1,100.0,0,0,0.0,0,0,0.0,0,0,0,0.0,1,0.0
Michael Doleac,7,0,2,0.0,0,2,0.0,0,0,0.0,4,6,66.67,0,0,2,0.0,3,0.0
Michael Finley,83,33,85,38.82,13,35,37.14,20,50,40.0,45,59,76.27,30,2,5,0.0,6,2.0
Michael Harris,1,0,0,0.0,0,0,0.0,0,0,0.0,0,0,0.0,0,0,0,,1,0.0
Michael Kidd-Gilchrist,43,10,18,55.56,10,17,58.82,0,1,0.0,23,37,62.16,9,2,11,0.0,6,0.0
Michael Olowokandi,3,0,2,0.0,0,2,0.0,0,0,0.0,0,0,0.0,0,1,3,0.0,2,0.0
Michael Redd,144,107,277,38.63,81,187,43.32,26,90,28.89,143,172,83.14,49,18,19,0.0,8,1.0
Michael Ruffin,16,3,8,37.5,3,8,37.5,0,0,0.0,3,6,50.0,2,1,7,0.0,4,0.0
Michael Sweetney,15,6,12,50.0,6,12,50.0,0,0,0.0,7,11,63.64,4,1,8,0.0,2,0.0
Mickael Gelabale,10,5,6,83.33,4,5,80.0,1,1,100.0,4,7,57.14,5,1,1,0.0,1,0.0
Mickael Pietrus,49,19,51,37.25,11,17,64.71,8,34,23.53,8,13,61.54,12,1,12,0.0,9,0.0
Mickell Gladness,1,0,1,0.0,0,1,0.0,0,0,0.0,0,0,0.0,0,0,0,0.0,1,0.0
Mike Bibby,147,86,227,37.89,50,102,49.02,36,125,28.8,83,101,82.18,48,6,10,0.0,8,1.0
Mike Conley,218,124,325,38.15,84,202,41.58,40,123,32.52,178,237,75.11,45,15,6,0.0,11,4.0
Mike Dunleavy,162,54,152,35.53,28,70,40.0,26,82,31.71,71,95,74.74,34,6,24,0.0,13,1.0
Mike James,94,56,152,36.84,29,79,36.71,27,73,36.99,56,78,71.79,22,10,5,0.0,7,1.0
Mike Miller,141,72,166,43.37,35,79,44.3,37,87,42.53,40,48,83.33,44,7,17,1.0,12,4.0
Mike Muscala,9,5,8,62.5,2,3,66.67,3,5,60.0,0,0,0.0,5,1,5,0.0,3,0.0
Mike Scott,19,11,27,40.74,6,10,60.0,5,17,29.41,1,1,100.0,10,1,2,0.0,5,0.0
Mike Taylor,3,3,5,60.0,3,5,60.0,0,0,0.0,0,0,0.0,1,0,0,0.0,1,0.0
Mikki Moore,34,12,21,57.14,12,19,63.16,0,2,0.0,9,18,50.0,7,1,10,0.0,7,0.0
Miles Plumlee,19,7,12,58.33,7,12,58.33,0,0,0.0,2,4,50.0,5,0,8,0.0,5,0.0
Milos Teodosic,6,1,3,33.33,0,0,0.0,1,3,33.33,0,1,0.0,1,0,1,0.0,1,0.0
Milt Palacio,22,10,27,37.04,10,25,40.0,0,2,0.0,6,11,54.55,5,2,0,0.0,2,0.0
Mindaugas Kuzminskas,3,1,5,20.0,1,1,100.0,0,4,0.0,0,0,0.0,1,0,0,0.0,1,0.0
Miroslav Raduljica,1,0,0,0.0,0,0,0.0,0,0,0.0,0,0,0.0,0,0,0,,1,0.0
Mirza Teletovic,29,11,33,33.33,2,3,66.67,9,30,30.0,7,9,77.78,9,1,4,0.0,5,0.0
Mitch McGary,2,0,0,0.0,0,0,0.0,0,0,0.0,0,0,0.0,0,0,1,,1,0.0
Mo Williams,197,98,296,33.11,64,170,37.65,34,126,26.98,186,208,89.42,33,11,12,0.0,12,3.0
Monta Ellis,255,183,459,39.87,146,337,43.32,37,122,30.33,219,290,75.52,62,26,26,0.0,12,5.0
Montrezl Harrell,10,3,5,60.0,3,4,75.0,0,1,0.0,5,6,83.33,1,0,7,0.0,3,0.0
Moochie Norris,2,0,1,0.0,0,0,0.0,0,1,0.0,0,0,0.0,0,0,1,0.0,1,0.0
Morris Almond,1,0,1,0.0,0,1,0.0,0,0,0.0,0,0,0.0,0,0,0,0.0,1,0.0
Morris Peterson,63,26,77,33.77,12,41,29.27,14,36,38.89,31,34,91.18,14,4,13,0.0,5,0.0
Myles Turner,43,17,38,44.74,14,28,50.0,3,10,30.0,20,31,64.52,11,2,16,0.0,3,1.0
Nando De Colo,2,0,3,0.0,0,1,0.0,0,2,0.0,4,4,100.0,0,0,0,0.0,1,0.0
Nate Robinson,109,83,205,40.49,61,130,46.92,22,75,29.33,106,133,79.7,22,13,9,1.0,9,3.0
Nate Wolters,5,1,5,20.0,0,2,0.0,1,3,33.33,2,2,100.0,0,1,0,0.0,1,0.0
Nazr Mohammed,43,20,44,45.45,20,44,45.45,0,0,0.0,19,28,67.86,10,5,30,0.0,8,0.0
Ndudi Ebi,1,0,0,0.0,0,0,0.0,0,0,0.0,2,2,100.0,0,0,0,,1,0.0
Nemanja Bjelica,14,6,13,46.15,2,5,40.0,4,8,50.0,6,10,60.0,6,3,1,0.0,3,0.0
Nenad Krstic,41,17,36,47.22,17,36,47.22,0,0,0.0,20,27,74.07,14,5,17,0.0,7,0.0
Nene,139,69,120,57.5,69,118,58.47,0,2,0.0,75,120,62.5,46,11,44,1.0,12,4.0
Nerlens Noel,32,13,24,54.17,13,24,54.17,0,0,0.0,10,15,66.67,10,0,9,0.0,4,1.0
Nick Calathes,5,2,6,33.33,1,2,50.0,1,4,25.0,1,1,100.0,1,0,1,0.0,2,0.0
Nick Collison,82,29,52,55.77,29,52,55.77,0,0,0.0,29,45,64.44,18,4,32,0.0,12,0.0
Nick Fazekas,1,1,1,100.0,1,1,100.0,0,0,0.0,1,2,50.0,1,0,0,0.0,1,0.0
Nick Johnson,3,1,1,100.0,1,1,100.0,0,0,0.0,0,2,0.0,1,0,0,0.0,1,0.0
Nick Van Exel,17,6,16,37.5,3,6,50.0,3,10,30.0,7,9,77.78,4,0,2,0.0,2,0.0
Nick Young,92,45,137,32.85,23,58,39.66,22,79,27.85,51,61,83.61,26,8,9,0.0,10,1.0
Nicolas Batum,172,66,196,33.67,30,70,42.86,36,126,28.57,77,95,81.05,50,10,29,0.0,10,2.0
Nik Stauskas,19,9,29,31.03,3,10,30.0,6,19,31.58,7,9,77.78,7,3,1,0.0,3,0.0
Nikola Jokic,43,15,48,31.25,8,29,27.59,7,19,36.84,26,30,86.67,11,5,11,0.0,3,0.0
Nikola Mirotic,45,12,45,26.67,4,16,25.0,8,29,27.59,25,33,75.76,11,2,4,0.0,4,0.0
Nikola Pekovic,39,29,55,52.73,29,55,52.73,0,0,0.0,16,20,80.0,23,4,16,0.0,5,1.0
Nikola Vucevic,90,47,131,35.88,47,124,37.9,0,7,0.0,44,62,70.97,32,7,34,0.0,7,3.0
Noah Vonleh,3,2,2,100.0,2,2,100.0,0,0,0.0,0,0,0.0,1,0,2,0.0,2,0.0
Nolan Smith,4,1,2,50.0,1,1,100.0,0,1,0.0,2,4,50.0,0,0,0,0.0,2,0.0
Norman Powell,19,7,20,35.0,4,11,36.36,3,9,33.33,7,8,87.5,4,1,0,0.0,3,0.0
Norris Cole,27,7,20,35.0,4,9,44.44,3,11,27.27,11,18,61.11,6,1,0,0.0,6,0.0
O.J. Mayo,152,92,272,33.82,56,145,38.62,36,127,28.35,89,114,78.07,38,19,12,0.0,8,2.0
OG Anunoby,2,0,0,0.0,0,0,0.0,0,0,0.0,1,2,50.0,0,0,0,,1,0.0
Obinna Ekezie,6,2,3,66.67,2,3,66.67,0,0,0.0,3,4,75.0,2,0,1,0.0,1,0.0
Okaro White,1,1,1,100.0,0,0,0.0,1,1,100.0,2,2,100.0,1,0,0,0.0,1,0.0
Oleksiy Pecherov,1,0,1,0.0,0,0,0.0,0,1,0.0,0,0,0.0,0,0,0,0.0,1,0.0
Omer Asik,27,6,15,40.0,6,15,40.0,0,0,0.0,8,12,66.67,4,4,10,0.0,6,0.0
Omri Casspi,44,13,40,32.5,9,19,47.37,4,21,19.05,14,23,60.87,11,1,10,0.0,5,1.0
Orien Greene,11,4,7,57.14,4,6,66.67,0,1,0.0,4,8,50.0,1,0,3,0.0,1,0.0
Orlando Johnson,1,0,1,0.0,0,0,0.0,0,1,0.0,0,0,0.0,0,0,0,0.0,1,0.0
Othella Harrington,5,3,7,42.86,3,7,42.86,0,0,0.0,4,5,80.0,3,1,3,0.0,2,0.0
Othello Hunter,1,0,0,0.0,0,0,0.0,0,0,0.0,0,0,0.0,0,0,0,,1,0.0
Othyus Jeffers,4,0,1,0.0,0,1,0.0,0,0,0.0,2,4,50.0,0,1,2,0.0,1,0.0
Otto Porter,16,5,12,41.67,3,6,50.0,2,6,33.33,2,3,66.67,4,0,4,0.0,3,0.0
Otto Porter Jr.,39,15,36,41.67,8,17,47.06,7,19,36.84,22,27,81.48,10,1,12,0.0,2,2.0
P.J. Brown,44,15,42,35.71,15,42,35.71,0,0,0.0,31,33,93.94,12,2,16,0.0,3,0.0
PJ Hairston,3,1,3,33.33,0,0,0.0,1,3,33.33,0,0,0.0,1,0,0,0.0,2,0.0
PJ Tucker,100,39,82,47.56,31,57,54.39,8,25,32.0,43,56,76.79,19,3,50,1.0,6,2.0
Pablo Prigioni,8,0,6,0.0,0,2,0.0,0,4,0.0,1,2,50.0,0,1,1,0.0,3,0.0
Pape Sow,2,0,1,0.0,0,1,0.0,0,0,0.0,0,0,0.0,0,1,0,0.0,2,0.0
Pascal Siakam,5,1,1,100.0,1,1,100.0,0,0,0.0,0,0,0.0,1,0,1,0.0,1,0.0
Pat Burke,1,0,3,0.0,0,3,0.0,0,0,0.0,2,2,100.0,0,0,1,0.0,1,0.0
Pat Connaughton,9,2,5,40.0,2,4,50.0,0,1,0.0,4,4,100.0,0,2,2,0.0,2,0.0
Pat Garrity,8,4,13,30.77,1,3,33.33,3,10,30.0,0,0,0.0,4,0,1,0.0,2,0.0
Patrick Beverley,50,16,41,39.02,6,13,46.15,10,28,35.71,23,32,71.88,11,1,14,0.0,6,0.0
Patrick O'Bryant,1,0,1,0.0,0,1,0.0,0,0,0.0,0,0,0.0,0,1,0,0.0,1,0.0
Patrick Patterson,81,28,59,47.46,17,30,56.67,11,29,37.93,12,16,75.0,22,3,30,0.0,8,2.0
Patty Mills,45,21,58,36.21,9,18,50.0,12,40,30.0,28,33,84.85,12,0,4,0.0,9,1.0
Pau Gasol,267,145,319,45.45,138,299,46.15,7,20,35.0,168,240,70.0,73,32,100,1.0,14,6.0
Paul Davis,1,0,1,0.0,0,1,0.0,0,0,0.0,0,0,0.0,0,0,0,0.0,1,0.0
Paul George,159,88,259,33.98,48,123,39.02,40,136,29.41,149,174,85.63,42,16,19,0.0,8,1.0
Paul Millsap,202,141,317,44.48,115,243,47.33,26,74,35.14,134,174,77.01,97,24,73,1.0,12,6.0
Paul Pierce,305,199,515,38.64,134,340,39.41,65,175,37.14,279,364,76.65,83,36,20,0.0,13,5.0
Paul Zipser,7,2,5,40.0,1,2,50.0,1,3,33.33,0,0,0.0,2,0,3,0.0,2,0.0
Peja Stojakovic,88,40,113,35.4,14,45,31.11,26,68,38.24,58,64,90.62,31,2,5,0.0,7,1.0
Pero Antic,17,7,14,50.0,2,4,50.0,5,10,50.0,6,6,100.0,6,1,4,0.0,2,0.0
Perry Jones,1,0,1,0.0,0,1,0.0,0,0,0.0,0,0,0.0,0,0,0,0.0,1,0.0
Phil Pressey,5,3,7,42.86,2,5,40.0,1,2,50.0,2,2,100.0,1,0,0,0.0,3,0.0
Pooh Jeter,7,4,8,50.0,3,6,50.0,1,2,50.0,1,2,50.0,1,1,0,0.0,1,0.0
Pops Mensah-Bonsu,1,0,1,0.0,0,1,0.0,0,0,0.0,0,0,0.0,0,1,1,0.0,1,0.0
Predrag Drobnjak,9,3,11,27.27,2,7,28.57,1,4,25.0,2,2,100.0,2,0,3,0.0,1,0.0
Primoz Brezec,29,21,43,48.84,21,43,48.84,0,0,0.0,15,20,75.0,15,2,13,0.0,3,2.0
Quentin Richardson,75,33,83,39.76,16,35,45.71,17,48,35.42,25,30,83.33,17,7,12,0.0,8,2.0
Quincy Acy,26,3,14,21.43,1,4,25.0,2,10,20.0,6,8,75.0,2,2,6,0.0,5,0.0
Quincy Douby,10,2,11,18.18,2,5,40.0,0,6,0.0,7,8,87.5,0,0,1,0.0,3,0.0
Quincy Miller,1,0,0,0.0,0,0,0.0,0,0,0.0,0,0,0.0,0,0,0,,1,0.0
Quincy Pondexter,19,8,20,40.0,6,10,60.0,2,10,20.0,5,6,83.33,4,1,2,0.0,3,0.0
Quinn Cook,4,0,3,0.0,0,2,0.0,0,1,0.0,4,4,100.0,0,2,1,0.0,2,0.0
Quinton Ross,36,14,27,51.85,12,22,54.55,2,5,40.0,3,4,75.0,10,4,6,0.0,6,0.0
Qyntel Woods,5,5,5,100.0,4,4,100.0,1,1,100.0,1,1,100.0,2,0,1,0.0,1,0.0
Raef LaFrentz,28,3,22,13.64,2,6,33.33,1,16,6.25,9,12,75.0,2,1,12,0.0,2,0.0
Rafer Alston,112,47,122,38.52,27,59,45.76,20,63,31.75,90,127,70.87,21,4,11,0.0,6,2.0
Raja Bell,97,35,94,37.23,18,45,40.0,17,49,34.69,45,54,83.33,28,5,12,0.0,8,1.0
Rajon Rondo,179,62,181,34.25,58,157,36.94,4,24,16.67,38,68,55.88,17,10,34,0.0,12,1.0
Ramon Sessions,97,42,117,35.9,39,100,39.0,3,17,17.65,71,103,68.93,16,10,15,0.0,10,1.0
Randolph Morris,2,0,0,0.0,0,0,0.0,0,0,0.0,0,0,0.0,0,0,1,,2,0.0
Randy Foye,157,86,235,36.6,60,137,43.8,26,98,26.53,107,123,86.99,29,15,16,0.0,11,2.0
Rashad McCants,40,18,56,32.14,10,25,40.0,8,31,25.81,10,13,76.92,10,1,4,0.0,4,0.0
Rashard Lewis,137,72,173,41.62,41,97,42.27,31,76,40.79,95,115,82.61,37,9,34,1.0,9,3.0
Rasheed Wallace,118,55,179,30.73,32,90,35.56,23,89,25.84,30,45,66.67,35,5,30,0.0,6,0.0
Rasho Nesterovic,21,10,19,52.63,10,19,52.63,0,0,0.0,4,5,80.0,8,1,4,0.0,5,0.0
Rasual Butler,90,49,120,40.83,21,46,45.65,28,74,37.84,46,54,85.19,35,0,14,1.0,11,2.0
Raul Lopez,3,4,4,100.0,2,2,100.0,2,2,100.0,1,3,33.33,2,0,0,0.0,1,0.0
Raul Neto,2,0,1,0.0,0,0,0.0,0,1,0.0,0,2,0.0,0,0,0,0.0,1,0.0
Ray Allen,220,142,349,40.69,65,151,43.05,77,198,38.89,149,169,88.17,88,17,27,1.0,10,5.0
Ray McCallum,12,5,18,27.78,4,12,33.33,1,6,16.67,1,2,50.0,2,0,4,0.0,2,0.0
Raymond Felton,228,126,367,34.33,102,270,37.78,24,97,24.74,192,258,74.42,35,29,39,0.0,13,2.0
Reggie Bullock,11,2,11,18.18,0,2,0.0,2,9,22.22,1,2,50.0,2,1,1,0.0,3,0.0
Reggie Evans,32,3,10,30.0,3,10,30.0,0,0,0.0,11,19,57.89,0,1,14,0.0,9,0.0
Reggie Jackson,83,64,173,36.99,52,127,40.94,12,46,26.09,107,123,86.99,8,11,7,0.0,6,2.0
Reggie Miller,24,17,42,40.48,10,14,71.43,7,28,25.0,16,17,94.12,15,0,2,0.0,1,1.0
Reggie Williams,26,10,27,37.04,3,12,25.0,7,15,46.67,8,11,72.73,9,3,4,0.0,4,0.0
Renaldo Balkman,12,2,3,66.67,2,3,66.67,0,0,0.0,4,4,100.0,0,1,7,0.0,2,0.0
Richard Hamilton,142,100,265,37.74,90,219,41.1,10,46,21.74,150,175,85.71,60,22,19,0.0,9,4.0
Richard Jefferson,176,87,210,41.43,67,148,45.27,20,62,32.26,129,169,76.33,60,15,28,1.0,13,3.0
Richaun Holmes,14,3,7,42.86,1,2,50.0,2,5,40.0,5,6,83.33,3,0,4,0.0,3,0.0
Richie Frahm,8,4,11,36.36,2,4,50.0,2,7,28.57,3,4,75.0,3,1,0,0.0,3,0.0
Rick Brunson,20,8,23,34.78,4,11,36.36,4,12,33.33,18,23,78.26,5,0,2,0.0,1,0.0
Ricky Davis,118,78,196,39.8,54,128,42.19,24,68,35.29,78,99,78.79,40,6,20,0.0,6,2.0
Ricky Ledo,1,1,1,100.0,1,1,100.0,0,0,0.0,0,0,0.0,0,0,0,0.0,1,0.0
Ricky Rubio,111,36,114,31.58,23,75,30.67,13,39,33.33,95,118,80.51,15,11,15,0.0,7,1.0
Rob Kurz,1,0,0,0.0,0,0,0.0,0,0,0.0,2,2,100.0,0,0,1,,1,0.0
Robbie Hummel,4,2,3,66.67,1,1,100.0,1,2,50.0,0,0,0.0,2,0,1,0.0,2,0.0
Robert Covington,64,30,80,37.5,11,27,40.74,19,53,35.85,45,56,80.36,24,6,11,0.0,4,2.0
Robert Horry,23,8,20,40.0,2,5,40.0,6,15,40.0,4,8,50.0,8,0,6,0.0,4,0.0
Robert Sacre,4,1,4,25.0,1,4,25.0,0,0,0.0,4,4,100.0,1,0,1,0.0,2,0.0
Robert Swift,2,1,1,100.0,1,1,100.0,0,0,0.0,3,4,75.0,1,0,0,0.0,1,0.0
Robert Traylor,4,2,3,66.67,2,2,100.0,0,1,0.0,2,2,100.0,1,0,3,0.0,1,0.0
Robin Lopez,71,24,53,45.28,24,51,47.06,0,2,0.0,35,42,83.33,18,6,31,0.0,9,0.0
Rod Strickland,1,0,0,0.0,0,0,0.0,0,0,0.0,2,2,100.0,0,0,0,,1,0.0
Rodney Buford,5,0,5,0.0,0,4,0.0,0,1,0.0,2,2,100.0,0,1,0,0.0,1,0.0
Rodney Carney,17,6,14,42.86,4,7,57.14,2,7,28.57,6,7,85.71,5,2,1,0.0,5,0.0
Rodney Hood,47,31,81,38.27,21,43,48.84,10,38,26.32,26,31,83.87,10,5,3,0.0,4,0.0
Rodney McGruder,4,1,3,33.33,1,2,50.0,0,1,0.0,0,0,0.0,1,0,2,0.0,1,0.0
Rodney Rogers,10,4,10,40.0,3,5,60.0,1,5,20.0,1,2,50.0,3,1,2,0.0,1,0.0
Rodney Stuckey,137,78,214,36.45,62,167,37.13,16,47,34.04,95,121,78.51,21,23,20,0.0,10,3.0
Rodney White,5,3,7,42.86,1,5,20.0,2,2,100.0,0,0,0.0,3,0,0,0.0,1,0.0
Rodrigue Beaubois,13,7,13,53.85,7,11,63.64,0,2,0.0,4,7,57.14,2,1,0,0.0,4,0.0
Roger Mason Jr.,44,22,60,36.67,9,15,60.0,13,45,28.89,17,18,94.44,10,4,3,0.0,7,1.0
Roko Leni Ukic,6,9,9,100.0,7,7,100.0,2,2,100.0,0,0,0.0,1,0,0,0.0,1,0.0
Ron Baker,4,1,3,33.33,0,1,0.0,1,2,50.0,2,2,100.0,0,0,0,0.0,2,0.0
Ron Mercer,4,2,5,40.0,2,5,40.0,0,0,0.0,0,0,0.0,2,0,1,0.0,1,0.0
Ronald Dupree,4,2,3,66.67,2,3,66.67,0,0,0.0,2,2,100.0,1,0,2,0.0,3,0.0
Ronald Murray,58,34,66,51.52,22,42,52.38,12,24,50.0,31,42,73.81,14,4,3,1.0,6,2.0
Rondae Hollis-Jefferson,18,5,14,35.71,5,13,38.46,0,1,0.0,7,10,70.0,3,2,11,0.0,3,1.0
Ronnie Brewer,48,13,24,54.17,13,22,59.09,0,2,0.0,35,48,72.92,8,2,9,0.0,6,0.0
Ronnie Price,25,4,20,20.0,3,13,23.08,1,7,14.29,10,17,58.82,0,2,4,0.0,9,0.0
Ronny Turiaf,44,13,17,76.47,13,17,76.47,0,0,0.0,9,23,39.13,9,2,17,0.0,8,0.0
Roy Hibbert,95,30,81,37.04,30,79,37.97,0,2,0.0,37,48,77.08,17,5,35,0.0,7,1.0
Royal Ivey,21,4,16,25.0,2,10,20.0,2,6,33.33,6,13,46.15,3,1,0,0.0,6,0.0
Royce O'Neale,1,0,0,0.0,0,0,0.0,0,0,0.0,2,2,100.0,0,0,0,,1,0.0
Ruben Patterson,42,17,37,45.95,16,33,48.48,1,4,25.0,29,42,69.05,14,6,14,0.0,4,0.0
Rudy Fernandez,38,18,47,38.3,3,9,33.33,15,38,39.47,14,17,82.35,13,1,10,0.0,4,0.0
Rudy Gay,242,176,450,39.11,137,334,41.02,39,116,33.62,116,163,71.17,72,35,44,0.0,12,4.0
Rudy Gobert,50,19,33,57.58,19,33,57.58,0,0,0.0,29,55,52.73,13,4,33,0.0,4,1.0
Russ Smith,1,1,1,100.0,1,1,100.0,0,0,0.0,1,1,100.0,0,0,0,0.0,1,0.0
Russell Westbrook,260,232,619,37.48,194,447,43.4,38,172,22.09,270,332,81.33,35,37,77,0.0,10,5.0
Ryan Anderson,94,42,117,35.9,16,36,44.44,26,81,32.1,40,47,85.11,29,6,28,0.0,10,1.0
Ryan Arcidiacono,1,0,0,0.0,0,0,0.0,0,0,0.0,0,0,0.0,0,0,0,,1,0.0
Ryan Bowen,5,1,4,25.0,1,4,25.0,0,0,0.0,2,2,100.0,1,0,1,0.0,2,0.0
Ryan Gomes,73,24,71,33.8,18,44,40.91,6,27,22.22,30,39,76.92,14,4,26,0.0,7,0.0
Ryan Hollins,11,3,6,50.0,3,6,50.0,0,0,0.0,1,4,25.0,2,2,3,0.0,6,0.0
Ryan Kelly,12,3,9,33.33,1,4,25.0,2,5,40.0,5,7,71.43,3,1,3,0.0,3,0.0
Salah Mejri,11,0,0,0.0,0,0,0.0,0,0,0.0,4,10,40.0,0,0,6,,3,0.0
Salim Stoudamire,22,16,37,43.24,5,13,38.46,11,24,45.83,1,2,50.0,12,1,0,0.0,3,1.0
Sam Cassell,55,23,83,27.71,18,46,39.13,5,37,13.51,40,43,93.02,7,3,3,0.0,4,0.0
Sam Dekker,3,1,2,50.0,1,1,100.0,0,1,0.0,1,2,50.0,1,0,1,0.0,2,0.0
Sam Young,13,5,13,38.46,4,10,40.0,1,3,33.33,4,6,66.67,4,1,2,0.0,3,0.0
Samardo Samuels,5,2,5,40.0,2,5,40.0,0,0,0.0,1,2,50.0,0,0,2,0.0,2,0.0
Samuel Dalembert,128,44,82,53.66,44,82,53.66,0,0,0.0,54,85,63.53,25,6,55,1.0,11,1.0
Sarunas Jasikevicius,13,6,16,37.5,3,6,50.0,3,10,30.0,11,12,91.67,2,0,0,0.0,2,0.0
Sasha Pavlovic,28,13,41,31.71,5,17,29.41,8,24,33.33,9,14,64.29,12,6,5,0.0,6,0.0
Sasha Vujacic,48,20,58,34.48,5,15,33.33,15,43,34.88,22,29,75.86,14,1,2,0.0,8,0.0
Scot Pollard,4,2,3,66.67,2,3,66.67,0,0,0.0,0,0,0.0,0,1,2,0.0,2,0.0
Scott Padgett,11,8,12,66.67,3,3,100.0,5,9,55.56,0,2,0.0,6,0,2,0.0,3,0.0
Sean Kilpatrick,15,9,24,37.5,7,16,43.75,2,8,25.0,12,15,80.0,1,1,0,0.0,4,0.0
Sean Marks,4,2,3,66.67,2,3,66.67,0,0,0.0,4,7,57.14,1,0,2,0.0,2,0.0
Sean May,9,4,14,28.57,3,12,25.0,1,2,50.0,1,4,25.0,2,1,3,0.0,2,0.0
Sean Singletary,1,0,2,0.0,0,1,0.0,0,1,0.0,0,0,0.0,0,0,1,0.0,1,0.0
Sean Williams,5,2,3,66.67,2,3,66.67,0,0,0.0,2,2,100.0,1,1,3,0.0,2,0.0
Sebastian Telfair,62,17,71,23.94,11,36,30.56,6,35,17.14,24,35,68.57,2,4,3,0.0,10,0.0
Semi Ojeleye,1,0,0,0.0,0,0,0.0,0,0,0.0,0,0,0.0,0,0,1,,1,0.0
Serge Ibaka,135,47,114,41.23,39,82,47.56,8,32,25.0,39,50,78.0,29,5,56,1.0,9,3.0
Sergey Karasev,2,0,1,0.0,0,1,0.0,0,0,0.0,0,2,0.0,0,1,0,0.0,1,0.0
Sergio Rodriguez,12,3,12,25.0,2,9,22.22,1,3,33.33,7,11,63.64,0,2,0,0.0,4,0.0
Seth Curry,14,10,22,45.45,7,11,63.64,3,11,27.27,8,10,80.0,3,2,0,0.0,2,1.0
Shabazz Muhammad,15,4,14,28.57,3,7,42.86,1,7,14.29,6,9,66.67,3,0,3,0.0,4,0.0
Shabazz Napier,12,4,9,44.44,3,5,60.0,1,4,25.0,6,6,100.0,1,0,1,0.0,4,0.0
Shammond Williams,1,0,0,0.0,0,0,0.0,0,0,0.0,1,2,50.0,0,0,1,,1,0.0
Shandon Anderson,5,0,0,0.0,0,0,0.0,0,0,0.0,1,2,50.0,0,0,2,,2,0.0
Shane Battier,128,28,104,26.92,10,34,29.41,18,70,25.71,29,33,87.88,20,2,34,0.0,10,0.0
Shane Larkin,21,6,20,30.0,5,13,38.46,1,7,14.29,18,19,94.74,3,0,1,0.0,4,0.0
Shannon Brown,30,20,46,43.48,17,37,45.95,3,9,33.33,16,19,84.21,11,4,6,0.0,8,0.0
Shaquille Harrison,1,0,1,0.0,0,1,0.0,0,0,0.0,0,0,0.0,0,0,0,0.0,1,0.0
Shaquille O'Neal,60,25,56,44.64,25,56,44.64,0,0,0.0,25,69,36.23,9,3,32,0.0,7,1.0
Shareef Abdur-Rahim,27,9,27,33.33,6,19,31.58,3,8,37.5,20,26,76.92,4,2,5,0.0,3,0.0
Shaun Livingston,67,26,54,48.15,26,52,50.0,0,2,0.0,32,47,68.09,14,2,13,0.0,13,0.0
Shavlik Randolph,5,0,1,0.0,0,1,0.0,0,0,0.0,0,0,0.0,0,0,4,0.0,4,0.0
Shawn Bradley,1,1,1,100.0,1,1,100.0,0,0,0.0,0,0,0.0,0,0,1,0.0,1,0.0
Shawn Long,1,0,0,0.0,0,0,0.0,0,0,0.0,0,0,0.0,0,0,1,,1,0.0
Shawn Marion,154,94,184,51.09,88,163,53.99,6,21,28.57,73,89,82.02,68,10,38,1.0,11,5.0
Shawne Williams,26,3,19,15.79,1,6,16.67,2,13,15.38,10,13,76.92,2,0,3,0.0,6,0.0
Shelden Williams,16,4,9,44.44,4,8,50.0,0,1,0.0,12,14,85.71,2,0,6,0.0,5,0.0
Shelvin Mack,27,7,27,25.93,6,20,30.0,1,7,14.29,10,16,62.5,5,4,6,0.0,7,0.0
Sindarius Thornwell,1,1,1,100.0,1,1,100.0,0,0,0.0,0,0,0.0,0,0,0,0.0,1,0.0
Skal Labissiere,3,2,2,100.0,1,1,100.0,1,1,100.0,1,2,50.0,2,0,0,0.0,2,0.0
Slava Medvedenko,1,0,1,0.0,0,1,0.0,0,0,0.0,0,0,0.0,0,0,0,0.0,1,0.0
Smush Parker,44,22,47,46.81,16,30,53.33,6,17,35.29,15,29,51.72,12,2,6,0.0,4,1.0
Solomon Alabi,1,1,2,50.0,1,2,50.0,0,0,0.0,0,0,0.0,0,1,1,0.0,1,0.0
Solomon Hill,30,8,18,44.44,7,13,53.85,1,5,20.0,16,20,80.0,4,0,7,0.0,4,0.0
Solomon Jones,3,4,5,80.0,4,4,100.0,0,1,0.0,2,2,100.0,2,0,3,0.0,3,0.0
Sonny Weems,12,5,11,45.45,4,7,57.14,1,4,25.0,3,7,42.86,4,1,2,0.0,2,0.0
Speedy Claxton,40,23,56,41.07,21,52,40.38,2,4,50.0,30,43,69.77,5,11,5,0.0,3,1.0
Spencer Dinwiddie,32,19,49,38.78,11,16,68.75,8,33,24.24,29,39,74.36,5,1,7,0.0,4,0.0
Spencer Hawes,67,31,75,41.33,21,47,44.68,10,28,35.71,11,15,73.33,25,6,20,1.0,10,1.0
Stacey Augmon,5,0,1,0.0,0,1,0.0,0,0,0.0,5,5,100.0,0,0,1,0.0,2,0.0
Stanley Johnson,19,3,8,37.5,0,1,0.0,3,7,42.86,12,13,92.31,3,0,2,0.0,3,0.0
Stephane Lasme,3,0,1,0.0,0,1,0.0,0,0,0.0,0,0,0.0,0,0,2,0.0,1,0.0
Stephen Curry,172,116,313,37.06,74,162,45.68,42,151,27.81,190,211,90.05,37,9,12,0.0,9,3.0
Stephen Graham,8,4,9,44.44,4,7,57.14,0,2,0.0,1,2,50.0,1,1,0,0.0,5,0.0
Stephen Jackson,162,81,242,33.47,54,125,43.2,27,117,23.08,113,142,79.58,46,14,12,0.0,9,1.0
Stephen Zimmerman,1,1,1,100.0,1,1,100.0,0,0,0.0,0,0,0.0,1,0,0,0.0,1,0.0
Stephon Marbury,80,72,182,39.56,65,144,45.14,7,38,18.42,70,95,73.68,11,14,6,0.0,4,2.0
Steve Blake,110,32,114,28.07,15,43,34.88,17,71,23.94,58,76,76.32,20,3,12,0.0,12,1.0
Steve Francis,62,37,101,36.63,35,87,40.23,2,14,14.29,67,86,77.91,7,3,12,0.0,4,0.0
Steve Nash,199,151,343,44.02,104,208,50.0,47,135,34.81,246,277,88.81,28,8,8,1.0,10,5.0
Steve Novak,28,7,27,25.93,0,6,0.0,7,21,33.33,6,9,66.67,7,0,6,0.0,8,0.0
Steven Adams,58,14,20,70.0,14,20,70.0,0,0,0.0,11,22,50.0,7,1,38,0.0,4,0.0
Steven Hunter,7,2,6,33.33,2,6,33.33,0,0,0.0,1,4,25.0,1,1,3,0.0,3,0.0
Steven Smith,9,2,17,11.76,2,8,25.0,0,9,0.0,1,2,50.0,1,0,0,0.0,1,0.0
Stromile Swift,16,7,15,46.67,7,14,50.0,0,1,0.0,12,14,85.71,5,1,7,0.0,4,0.0
Sundiata Gaines,14,3,11,27.27,0,2,0.0,3,9,33.33,4,9,44.44,3,2,4,0.0,3,0.0
T.J. Ford,87,63,133,47.37,55,106,51.89,8,27,29.63,66,90,73.33,10,12,14,1.0,7,3.0
T.J. McConnell,21,11,22,50.0,9,19,47.37,2,3,66.67,7,8,87.5,6,1,1,0.0,2,1.0
TJ McConnell,4,1,4,25.0,1,4,25.0,0,0,0.0,1,2,50.0,0,0,0,0.0,1,0.0
TJ Warren,31,12,31,38.71,12,24,50.0,0,7,0.0,27,32,84.38,6,2,3,0.0,4,1.0
Taj Gibson,92,23,61,37.7,23,60,38.33,0,1,0.0,29,47,61.7,19,5,29,0.0,9,0.0
Tamar Slay,1,0,0,0.0,0,0,0.0,0,0,0.0,0,2,0.0,0,0,0,,1,0.0
Tarence Kinsey,6,4,5,80.0,2,3,66.67,2,2,100.0,9,9,100.0,2,0,0,0.0,3,0.0
Tarik Black,7,4,5,80.0,4,5,80.0,0,0,0.0,3,8,37.5,3,0,4,0.0,3,0.0
Taurean Prince,19,9,21,42.86,2,7,28.57,7,14,50.0,12,12,100.0,6,3,2,0.0,2,1.0
Tayshaun Prince,205,97,240,40.42,82,192,42.71,15,48,31.25,54,80,67.5,42,10,54,1.0,12,4.0
Terrel Harris,1,1,3,33.33,1,2,50.0,0,1,0.0,0,0,0.0,0,1,2,0.0,1,0.0
Terrence Jones,26,10,20,50.0,8,16,50.0,2,4,50.0,11,19,57.89,8,5,9,0.0,4,0.0
Terrence Ross,50,19,51,37.25,7,13,53.85,12,38,31.58,25,30,83.33,15,2,3,0.0,6,0.0
Terrence Williams,14,4,12,33.33,4,10,40.0,0,2,0.0,7,9,77.78,3,0,2,0.0,4,0.0
Terry Rozier,16,8,16,50.0,2,5,40.0,6,11,54.55,3,4,75.0,5,0,2,0.0,3,1.0
Thabo Sefolosha,90,15,43,34.88,11,22,50.0,4,21,19.05,33,40,82.5,9,3,9,0.0,12,0.0
Thaddeus Young,158,78,173,45.09,68,147,46.26,10,26,38.46,51,73,69.86,47,16,58,1.0,11,5.0
Theo Ratliff,24,5,13,38.46,5,13,38.46,0,0,0.0,5,12,41.67,2,0,13,0.0,5,0.0
Theron Smith,1,0,0,0.0,0,0,0.0,0,0,0.0,0,0,0.0,0,0,0,,1,0.0
Thomas Robinson,8,1,2,50.0,1,2,50.0,0,0,0.0,1,5,20.0,1,1,3,0.0,3,0.0
Thon Maker,3,4,7,57.14,3,3,100.0,1,4,25.0,0,0,0.0,3,0,1,0.0,2,0.0
Tiago Splitter,30,11,28,39.29,11,28,39.29,0,0,0.0,8,14,57.14,5,8,13,0.0,6,0.0
Tibor Pleiss,1,0,1,0.0,0,1,0.0,0,0,0.0,0,0,0.0,0,0,0,0.0,1,0.0
Tierre Brown,4,0,4,0.0,0,2,0.0,0,2,0.0,3,4,75.0,0,0,1,0.0,1,0.0
Tim Duncan,232,146,333,43.84,145,322,45.03,1,11,9.09,120,187,64.17,74,33,96,1.0,12,6.0
Tim Frazier,12,3,9,33.33,2,3,66.67,1,6,16.67,10,13,76.92,1,1,2,0.0,3,0.0
Tim Hardaway Jr.,53,30,77,38.96,11,31,35.48,19,46,41.3,33,46,71.74,22,3,4,0.0,4,3.0
Tim Quarterman,2,0,0,0.0,0,0,0.0,0,0,0.0,2,4,50.0,0,0,1,,2,0.0
Tim Thomas,46,31,68,45.59,13,29,44.83,18,39,46.15,12,17,70.59,24,3,6,1.0,5,2.0
Timofey Mozgov,15,9,19,47.37,9,16,56.25,0,3,0.0,5,8,62.5,7,1,9,0.0,5,0.0
Timothe Luwawu-Cabarrot,3,1,2,50.0,1,2,50.0,0,0,0.0,2,2,100.0,0,0,0,0.0,1,0.0
Tobias Harris,94,38,93,40.86,29,58,50.0,9,35,25.71,55,72,76.39,23,7,21,1.0,7,1.0
Tom Gugliotta,8,7,14,50.0,5,8,62.5,2,6,33.33,1,2,50.0,6,0,0,0.0,1,0.0
Tomas Satoransky,10,1,8,12.5,1,4,25.0,0,4,0.0,9,13,69.23,0,1,2,0.0,1,0.0
Toney Douglas,32,12,35,34.29,6,16,37.5,6,19,31.58,25,29,86.21,6,3,4,0.0,6,0.0
Toni Kukoc,12,4,14,28.57,3,4,75.0,1,10,10.0,1,2,50.0,2,0,0,0.0,2,0.0
Tony Allen,106,38,64,59.38,37,59,62.71,1,5,20.0,61,87,70.11,25,7,20,1.0,13,0.0
Tony Battie,22,6,20,30.0,5,16,31.25,1,4,25.0,4,11,36.36,5,2,5,0.0,4,0.0
Tony Delk,15,8,16,50.0,6,12,50.0,2,4,50.0,10,13,76.92,2,2,2,0.0,2,0.0
Tony Massenburg,3,1,5,20.0,1,5,20.0,0,0,0.0,2,3,66.67,1,0,4,0.0,1,0.0
Tony Parker,208,164,371,44.2,147,320,45.94,17,51,33.33,142,193,73.58,42,24,11,1.0,13,10.0
Tony Snell,36,12,42,28.57,5,9,55.56,7,33,21.21,3,4,75.0,9,3,2,0.0,5,0.0
Tony Wroten,13,7,18,38.89,6,14,42.86,1,4,25.0,9,12,75.0,1,0,3,0.0,2,0.0
Torrey Craig,2,1,1,100.0,0,0,0.0,1,1,100.0,0,0,0.0,1,0,1,0.0,1,0.0
Tracy McGrady,102,65,190,34.21,42,121,34.71,23,69,33.33,64,92,69.57,28,8,11,0.0,8,0.0
Travis Best,10,4,10,40.0,2,6,33.33,2,4,50.0,5,7,71.43,2,1,0,0.0,1,0.0
Travis Diener,15,4,15,26.67,1,6,16.67,3,9,33.33,4,4,100.0,3,1,3,0.0,4,0.0
Travis Outlaw,89,58,131,44.27,48,99,48.48,10,32,31.25,51,64,79.69,32,7,17,1.0,9,2.0
Trenton Hassell,50,20,44,45.45,19,41,46.34,1,3,33.33,10,18,55.56,11,3,8,0.0,6,0.0
Trevor Ariza,199,64,196,32.65,28,76,36.84,36,120,30.0,64,87,73.56,47,12,27,0.0,13,1.0
Trevor Booker,56,16,40,40.0,15,34,44.12,1,6,16.67,19,33,57.58,6,3,25,0.0,8,0.0
Trey Burke,60,42,111,37.84,26,61,42.62,16,50,32.0,28,35,80.0,16,4,3,0.0,4,1.0
Trey Lyles,10,2,10,20.0,1,4,25.0,1,6,16.67,1,2,50.0,2,0,2,0.0,3,0.0
Tristan Thompson,85,29,51,56.86,29,51,56.86,0,0,0.0,27,43,62.79,17,11,48,0.0,7,0.0
Troy Daniels,22,13,34,38.24,2,7,28.57,11,27,40.74,0,1,0.0,12,1,1,0.0,5,0.0
Troy Hudson,19,8,26,30.77,4,13,30.77,4,13,30.77,9,12,75.0,4,0,1,0.0,3,0.0
Troy Murphy,88,21,48,43.75,14,23,60.87,7,25,28.0,39,55,70.91,13,3,32,0.0,8,0.0
Troy Williams,1,0,1,0.0,0,1,0.0,0,0,0.0,0,0,0.0,0,0,0,0.0,1,0.0
Ty Lawson,121,59,157,37.58,49,122,40.16,10,35,28.57,79,104,75.96,18,21,14,0.0,8,2.0
Tyler Cavanaugh,1,0,0,0.0,0,0,0.0,0,0,0.0,0,0,0.0,0,0,1,,1,0.0
Tyler Dorsey,6,0,2,0.0,0,1,0.0,0,1,0.0,2,2,100.0,0,0,0,0.0,1,0.0
Tyler Ennis,4,4,8,50.0,4,5,80.0,0,3,0.0,6,7,85.71,1,1,0,0.0,3,0.0
Tyler Hansbrough,22,9,17,52.94,9,16,56.25,0,1,0.0,15,20,75.0,5,2,8,0.0,7,0.0
Tyler Johnson,43,27,51,52.94,19,33,57.58,8,18,44.44,15,20,75.0,16,5,2,0.0,4,2.0
Tyler Ulis,8,2,5,40.0,1,1,100.0,1,4,25.0,2,4,50.0,0,0,0,0.0,2,0.0
Tyler Zeller,22,9,17,52.94,9,16,56.25,0,1,0.0,10,12,83.33,6,1,7,0.0,5,0.0
Tyreke Evans,176,113,296,38.18,101,235,42.98,12,61,19.67,121,167,72.46,26,32,23,0.0,9,4.0
Tyrone Wallace,1,1,1,100.0,1,1,100.0,0,0,0.0,0,0,0.0,0,0,0,0.0,1,0.0
Tyronn Lue,55,43,84,51.19,31,55,56.36,12,29,41.38,30,42,71.43,12,6,2,1.0,5,2.0
Tyrus Thomas,55,32,59,54.24,31,56,55.36,1,3,33.33,31,44,70.45,23,4,18,0.0,7,1.0
Tyshawn Taylor,3,3,6,50.0,2,5,40.0,1,1,100.0,1,2,50.0,0,0,0,0.0,1,0.0
Tyson Chandler,159,38,69,55.07,38,69,55.07,0,0,0.0,53,83,63.86,22,3,107,1.0,14,0.0
Tyus Jones,5,1,3,33.33,0,1,0.0,1,2,50.0,1,2,50.0,1,0,2,0.0,2,0.0
Udonis Haslem,140,60,126,47.62,60,125,48.0,0,1,0.0,96,126,76.19,42,9,52,1.0,12,3.0
Viacheslav Kravtsov,1,1,1,100.0,1,1,100.0,0,0,0.0,0,0,0.0,0,0,0,0.0,1,0.0
Victor Claver,1,1,1,100.0,0,0,0.0,1,1,100.0,0,0,0.0,1,0,1,0.0,1,0.0
Victor Oladipo,102,71,184,38.59,49,108,45.37,22,76,28.95,72,92,78.26,20,20,6,0.0,5,3.0
Viktor Khryapa,6,0,0,0.0,0,0,0.0,0,0,0.0,2,4,50.0,0,0,1,,3,0.0
Vince Carter,236,167,424,39.39,115,271,42.44,52,153,33.99,185,223,82.96,78,21,48,0.0,14,4.0
Vitaly Potapenko,2,0,1,0.0,0,1,0.0,0,0,0.0,0,0,0.0,0,0,2,0.0,2,0.0
Vitor Faverani,1,1,1,100.0,1,1,100.0,0,0,0.0,0,0,0.0,1,0,0,0.0,1,0.0
Vladimir Radmanovic,68,31,79,39.24,11,23,47.83,20,56,35.71,13,17,76.47,27,4,10,0.0,9,1.0
Von Wafer,9,9,13,69.23,6,9,66.67,3,4,75.0,4,7,57.14,5,1,1,0.0,4,0.0
Voshon Lenard,2,0,2,0.0,0,0,0.0,0,2,0.0,0,0,0.0,0,0,0,0.0,1,0.0
Wade Baldwin IV,1,0,1,0.0,0,1,0.0,0,0,0.0,1,2,50.0,0,0,0,0.0,2,0.0
Walker Russell,1,0,0,0.0,0,0,0.0,0,0,0.0,0,2,0.0,0,0,0,,1,0.0
Wally Szczerbiak,63,30,76,39.47,29,56,51.79,1,20,5.0,38,47,80.85,21,2,10,0.0,5,1.0
Walter Herrmann,11,9,14,64.29,2,3,66.67,7,11,63.64,3,4,75.0,8,0,1,0.0,2,0.0
Walter McCarty,6,0,7,0.0,0,1,0.0,0,6,0.0,0,0,0.0,0,0,2,0.0,1,0.0
Wayne Ellington,70,36,84,42.86,14,35,40.0,22,49,44.9,29,31,93.55,27,8,3,1.0,9,1.0
Wayne Selden,6,4,7,57.14,1,1,100.0,3,6,50.0,3,4,75.0,3,0,1,0.0,2,0.0
Wayne Simien,1,0,0,0.0,0,0,0.0,0,0,0.0,1,2,50.0,0,0,0,,1,0.0
Wesley Johnson,64,31,66,46.97,22,38,57.89,9,28,32.14,9,14,64.29,21,2,11,1.0,7,1.0
Wesley Matthews,184,71,225,31.56,30,64,46.88,41,161,25.47,98,122,80.33,50,14,18,0.0,9,2.0
Wesley Person,3,2,4,50.0,1,2,50.0,1,2,50.0,0,0,0.0,2,0,0,0.0,1,0.0
Will Barton,50,24,72,33.33,17,38,44.74,7,34,20.59,56,62,90.32,13,2,5,0.0,5,1.0
Will Bynum,46,35,83,42.17,33,70,47.14,2,13,15.38,64,79,81.01,3,11,7,1.0,8,1.0
Will Solomon,3,2,5,40.0,0,1,0.0,2,4,50.0,1,2,50.0,1,0,1,0.0,1,0.0
Willie Cauley-Stein,24,11,17,64.71,11,17,64.71,0,0,0.0,8,14,57.14,9,1,9,0.0,3,0.0
Willie Green,62,22,81,27.16,17,42,40.48,5,39,12.82,34,49,69.39,11,2,7,0.0,9,0.0
Willie Reed,1,0,0,0.0,0,0,0.0,0,0,0.0,1,2,50.0,0,0,0,,1,0.0
Willy Hernangomez,7,3,8,37.5,3,8,37.5,0,0,0.0,0,0,0.0,1,1,3,0.0,1,0.0
Wilson Chandler,124,49,141,34.75,33,86,38.37,16,55,29.09,47,68,69.12,28,9,25,0.0,10,2.0
Xavier Henry,8,3,7,42.86,3,5,60.0,0,2,0.0,2,2,100.0,2,0,1,0.0,3,0.0
Xavier Munford,1,0,1,0.0,0,1,0.0,0,0,0.0,0,0,0.0,0,0,0,0.0,1,0.0
Xavier Rathan-Mayes,1,0,1,0.0,0,0,0.0,0,1,0.0,0,0,0.0,0,0,0,0.0,1,0.0
Yakhouba Diawara,7,1,4,25.0,0,0,0.0,1,4,25.0,2,2,100.0,1,0,0,0.0,3,0.0
Yao Ming,93,51,113,45.13,51,110,46.36,0,3,0.0,78,99,78.79,32,7,24,1.0,5,3.0
Yi Jianlian,30,13,32,40.62,11,25,44.0,2,7,28.57,18,24,75.0,10,6,12,0.0,4,1.0
Yogi Ferrell,28,8,24,33.33,4,6,66.67,4,18,22.22,15,22,68.18,5,0,2,0.0,2,0.0
Zach Collins,1,1,1,100.0,0,0,0.0,1,1,100.0,0,0,0.0,1,0,0,0.0,1,0.0
Zach LaVine,58,35,95,36.84,18,41,43.9,17,54,31.48,37,42,88.1,18,5,3,0.0,4,1.0
Zach Randolph,278,172,422,40.76,160,386,41.45,12,36,33.33,222,294,75.51,66,38,131,1.0,14,7.0
Zarko Cabarkapa,3,2,3,66.67,2,3,66.67,0,0,0.0,0,0,0.0,1,0,2,0.0,2,0.0
Zaza Pachulia,94,32,68,47.06,32,67,47.76,0,1,0.0,48,64,75.0,20,8,59,1.0,11,0.0
Zeljko Rebraca,6,2,3,66.67,2,3,66.67,0,0,0.0,3,4,75.0,2,0,1,0.0,2,0.0
Zendon Hamilton,1,0,1,0.0,0,1,0.0,0,0,0.0,1,2,50.0,0,0,2,0.0,1,0.0
Zhou Qi,1,0,0,0.0,0,0,0.0,0,0,0.0,1,2,50.0,0,0,0,,1,0.0
Zoran Planinic,2,1,4,25.0,1,1,100.0,0,3,0.0,0,0,0.0,0,0,0,0.0,1,0.0
Zydrunas Ilgauskas,81,37,88,42.05,36,87,41.38,1,1,100.0,52,63,82.54,26,7,39,1.0,7,2.0
